who words test that this validation cat test words words words who use words words	who words test that this validation cat test words words words who use words words
cat test python test who cat cat that words cat cat cat test words python	cat test python test who cat cat that words cat cat cat test words python
this that use use words cat cat training validation python who validation training this cat	this that use use words cat cat training validation python who validation training this cat
training cat cat cat cat use who python use training cat cat training who test	training cat cat cat cat use who python use training cat cat training who test
validation test python cat that who that validation cat cat test validation test validation python	validation test python cat that who that validation cat cat test validation test validation python
cat that python python cat use cat who use test who test cat training python	cat that python python cat use cat who use test who test cat training python
cat python cat that validation that that who that cat test words cat python cat	cat python cat that validation that that who that cat test words cat python cat
use use training this use training this who who cat test this words cat validation	use use training this use training this who who cat test this words cat validation
test test use that cat cat use that validation validation this cat training who cat	test test use that cat cat use that validation validation this cat training who cat
words this cat this words test that this who validation cat that cat test cat	words this cat this words test that this who validation cat that cat test cat
use cat test training this cat who use that training python cat that training test	use cat test training this cat who use that training python cat that training test
that who that that use python validation words test that training that training validation words	that who that that use python validation words test that training that training validation words
validation cat words words words words cat who validation this cat cat words python use	validation cat words words words words cat who validation this cat cat words python use
cat who validation words words training this cat that words who use use training who	cat who validation words words training this cat that words who use use training who
this who cat who this words words who that this that words cat cat use	this who cat who this words words who that this that words cat cat use
python use this this training that who that who cat who who words words cat	python use this this training that who that who cat who who words words cat
who words test validation who python python that words who that cat that python who	who words test validation who python python that words who that cat that python who
this training validation use who cat cat cat python cat cat validation words this who	this training validation use who cat cat cat python cat cat validation words this who
that who training cat validation training training words that who words words use python words	that who training cat validation training training words that who words words use python words
that this that this python who validation validation test cat cat validation words training test	that this that this python who validation validation test cat cat validation words training test
cat training who who words this use python cat test words training that test who	cat training who who words this use python cat test words training that test who
that words test validation validation who who that this words validation words that words use	that words test validation validation who who that this words validation words that words use
that cat use validation test training this python use use test cat cat validation training	that cat use validation test training this python use use test cat cat validation training
this use who cat use cat words cat words test words cat words who validation	this use who cat use cat words cat words test words cat words who validation
python test use training who python use who that use cat test use who cat	python test use training who python use who that use cat test use who cat
who that python training use cat use use training python this who that words this	who that python training use cat use use training python this who that words this
words test who this validation cat test words use that test that cat test this	words test who this validation cat test words use that test that cat test this
that python who training cat cat this words words who test validation cat this python	that python who training cat cat this words words who test validation cat this python
python test validation cat test that test validation this cat test validation training cat words	python test validation cat test that test validation this cat test validation training cat words
who cat validation training use use words test cat test cat who this training cat	who cat validation training use use words test cat test cat who this training cat
cat this words cat this use cat validation cat this that cat use words who	cat this words cat this use cat validation cat this that cat use words who
training python python python test who cat use training test who test that words use	training python python python test who cat use training test who test that words use
validation cat python words python cat test python training words cat cat test this training	validation cat python words python cat test python training words cat cat test this training
training this use cat training use words python validation words who words that test validation	training this use cat training use words python validation words who words that test validation
who test training cat words test who who use training python validation cat words use	who test training cat words test who who use training python validation cat words use
validation this who words this cat words test test who cat this python python cat	validation this who words this cat words test test who cat this python python cat
cat test who cat cat cat python cat words cat python cat test training who	cat test who cat cat cat python cat words cat python cat test training who
python use who words cat cat cat cat python this who that test use that	python use who words cat cat cat cat python this who that test use that
use python that that words this cat validation validation who python cat python training test	use python that that words this cat validation validation who python cat python training test
cat words training that use cat cat this that cat validation use words training training	cat words training that use cat cat this that cat validation use words training training
use who that validation use words cat this cat who python words that who test	use who that validation use words cat this cat who python words that who test
test python use words words cat cat test this who words this cat python that	test python use words words cat cat test this who words this cat python that
cat python use cat words use python python cat use use validation who who cat	cat python use cat words use python python cat use use validation who who cat
words this words this python use python cat validation this python who python cat this	words this words this python use python cat validation this python who python cat this
test use cat this training python validation that cat this this training training python training	test use cat this training python validation that cat this this training training python training
validation cat python use use test python this this that validation who who cat this	validation cat python use use test python this this that validation who who cat this
use this python words use words test cat test training use test use cat cat	use this python words use words test cat test training use test use cat cat
who cat words cat python who cat cat test test test this use training cat	who cat words cat python who cat cat test test test this use training cat
who cat training python test python cat words test cat python training this who cat	who cat training python test python cat words test cat python training this who cat
that this training that words test test that cat words validation python this cat test	that this training that words test test that cat words validation python this cat test
cat this python use python this who use cat training words use who cat cat	cat this python use python this who use cat training words use who cat cat
use this cat this cat validation validation this validation use python python use training use	use this cat this cat validation validation this validation use python python use training use
that that that that this use cat validation that words cat words that validation validation	that that that that this use cat validation that words cat words that validation validation
test words cat that this test who cat that that python this use validation who	test words cat that this test who cat that that python this use validation who
cat use test validation python cat use use python python who validation validation this validation	cat use test validation python cat use use python python who validation validation this validation
cat training who cat training that this test that test test who python who cat	cat training who cat training that this test that test test who python who cat
cat that python use who this who words validation test use validation validation this this	cat that python use who this who words validation test use validation validation this this
training words python who who words cat this test python cat test use validation test	training words python who who words cat this test python cat test use validation test
use cat test that training use use test python cat this cat cat cat use	use cat test that training use use test python cat this cat cat cat use
training cat training use that python training validation validation validation who this who use validation	training cat training use that python training validation validation validation who this who use validation
cat validation python use that validation words training python words words this cat validation who	cat validation python use that validation words training python words words this cat validation who
use training that training test words python this training words this cat use cat test	use training that training test words python this training words this cat use cat test
training this who that validation this words that test that test words use cat python	training this who that validation this words that test that test words use cat python
cat cat that use who python cat python training test validation training who python cat	cat cat that use who python cat python training test validation training who python cat
this cat who that cat cat cat python cat that cat training who training cat	this cat who that cat cat cat python cat that cat training who training cat
that training validation that words training cat this validation training python cat use training validation	that training validation that words training cat this validation training python cat use training validation
cat that python python test use cat python this use validation words use who cat	cat that python python test use cat python this use validation words use who cat
words python cat cat cat cat python training words cat cat cat test words words	words python cat cat cat cat python training words cat cat cat test words words
test that that python test this cat who training cat validation validation this use test	test that that python test this cat who training cat validation validation this use test
this test use test training cat this this validation use training who that this test	this test use test training cat this this validation use training who that this test
validation cat that cat test test words training use test who python cat who cat	validation cat that cat test test words training use test who python cat who cat
words that who test python this training use cat who cat cat training training training	words that who test python this training use cat who cat cat training training training
that who test test cat this training who test words this this python cat validation	that who test test cat this training who test words this this python cat validation
who test this validation validation python cat test cat who words words that use validation	who test this validation validation python cat test cat who words words that use validation
this validation words training cat that training test that cat test cat that this training	this validation words training cat that training test that cat test cat that this training
cat training cat cat training words words words cat python training this this training cat	cat training cat cat training words words words cat python training this this training cat
words who this validation validation training use use validation who cat use use words cat	words who this validation validation training use use validation who cat use use words cat
validation use validation words cat training words who validation python who cat use test validation	validation use validation words cat training words who validation python who cat use test validation
this this python words that training use this training cat who test that use test	this this python words that training use this training cat who test that use test
that python words python python use this this test words who cat that who who	that python words python python use this this test words who cat that who who
this python that python who this validation who cat words who this use cat test	this python that python who this validation who cat words who this use cat test
test cat training that use training cat this words words that training validation this this	test cat training that use training cat this words words that training validation this this
cat python training cat validation cat this cat validation who that python cat use cat	cat python training cat validation cat this cat validation who that python cat use cat
test test words python cat training who that training this that that test python that	test test words python cat training who that training this that that test python that
this python test cat training training training validation cat validation that test cat words test	this python test cat training training training validation cat validation that test cat words test
python that that cat test cat this that validation words test training who this that	python that that cat test cat this that validation words test training who this that
test use use cat test validation test cat words cat that cat training this this	test use use cat test validation test cat words cat that cat training this this
training that cat test cat who words cat training cat that training test validation this	training that cat test cat who words cat training cat that training test validation this
cat use training who words cat use training python who words test cat this cat	cat use training who words cat use training python who words test cat this cat
this use this who training use test this python use python cat cat who training	this use this who training use test this python use python cat cat who training
python who this words cat who validation that use test python test that that that	python who this words cat who validation that use test python test that that that
cat test use use who validation training cat training cat training this that cat test	cat test use use who validation training cat training cat training this that cat test
that cat that words use that python who training test cat cat who words python	that cat that words use that python who training test cat cat who words python
this validation validation use training use this cat words that that that cat use validation	this validation validation use training use this cat words that that that cat use validation
training who training who words cat words use cat python words cat cat words validation	training who training who words cat words use cat python words cat cat words validation
who use who words this training use training training test test test validation validation training	who use who words this training use training training test test test validation validation training
that cat words who cat python training test python who words who cat cat words	that cat words who cat python training test python who words who cat cat words
cat this that test who words cat training this this this that validation words test	cat this that test who words cat training this this this that validation words test
that words validation python who who validation use cat python test test that who cat	that words validation python who who validation use cat python test test that who cat
that cat training that test training validation python this training use validation this validation test	that cat training that test training validation python this training use validation this validation test
who python cat words that test training cat python cat this training words training cat	who python cat words that test training cat python cat this training words training cat
who cat training cat test that who words cat who python this cat training cat	who cat training cat test that who words cat who python this cat training cat
validation training use cat test use validation who use python that test this words use	validation training use cat test use validation who use python that test this words use
training python validation cat use validation that python cat that cat training python this validation	training python validation cat use validation that python cat that cat training python this validation
this cat training who training python validation validation training use who test this python words	this cat training who training python validation validation training use who test this python words
who that python training python training validation this who validation this words use words cat	who that python training python training validation this who validation this words use words cat
that cat that cat that python cat validation training python test python this cat use	that cat that cat that python cat validation training python test python this cat use
validation validation that that validation words that this that test words that cat use use	validation validation that that validation words that this that test words that cat use use
this training use use cat use words words use validation cat test that that test	this training use use cat use words words use validation cat test that that test
training validation python words validation who cat test training python that training cat python that	training validation python words validation who cat test training python that training cat python that
words python this validation that training words validation that training that words this who who	words python this validation that training words validation that training that words this who who
training cat use cat python cat this this use test test that who cat test	training cat use cat python cat this this use test test that who cat test
python use test words cat that cat test python python this use python validation who	python use test words cat that cat test python python this use python validation who
cat this use validation cat words cat cat cat validation training this cat cat test	cat this use validation cat words cat cat cat validation training this cat cat test
use cat who python cat validation training validation use cat use that use python training	use cat who python cat validation training validation use cat use that use python training
cat that test test python who who that this this python who python this this	cat that test test python who who that this this python who python this this
that cat python cat test test test this use who cat words this that training	that cat python cat test test test this use who cat words this that training
words that cat training cat who training cat this who cat validation who who python	words that cat training cat who training cat this who cat validation who who python
training cat that python validation use who python test that this this test python words	training cat that python validation use who python test that this this test python words
who training use who words that this cat test who use python test that test	who training use who words that this cat test who use python test that test
cat training this validation python validation training validation test test that validation use words that	cat training this validation python validation training validation test test that validation use words that
python training training cat python test that use cat validation validation that cat that cat	python training training cat python test that use cat validation validation that cat that cat
test this training cat use test this that use test training this python cat cat	test this training cat use test this that use test training this python cat cat
who python this cat test who cat validation training python test words cat use python	who python this cat test who cat validation training python test words cat use python
that test cat words use cat this this use test this use use this cat	that test cat words use cat this this use test this use use this cat
that training cat use who this training use python words cat python validation cat cat	that training cat use who this training use python words cat python validation cat cat
cat validation python use training who validation this python use cat that that training this	cat validation python use training who validation this python use cat that that training this
words training python use who test who validation cat use test validation python who use	words training python use who test who validation cat use test validation python who use
who test that cat this this use python cat words python training who who validation	who test that cat this this use python cat words python training who who validation
training validation use that validation training that cat that who python who who cat python	training validation use that validation training that cat that who python who who cat python
training that cat that use validation cat test cat cat validation use that this use	training that cat that use validation cat test cat cat validation use that this use
training python that that cat cat words that validation python cat that test training validation	training python that that cat cat words that validation python cat that test training validation
python training use test who validation cat this python that that words use training validation	python training use test who validation cat this python that that words use training validation
use python cat cat training training python validation that training words cat words that who	use python cat cat training training python validation that training words cat words that who
validation this cat training who test training validation words python cat this training this that	validation this cat training who test training validation words python cat this training this that
that training validation cat validation who cat words cat cat who python words that who	that training validation cat validation who cat words cat cat who python words that who
cat use cat python cat cat this test test this who that words cat words	cat use cat python cat cat this test test this who that words cat words
validation use python words words python test that test use cat who cat python use	validation use python words words python test that test use cat who cat python use
use test test test this test words who cat training cat cat words python words	use test test test this test words who cat training cat cat words python words
that this validation cat that python use use this that that cat who python cat	that this validation cat that python use use this that that cat who python cat
that cat this this that who use cat cat this use who who cat that	that cat this this that who use cat cat this use who who cat that
training cat training cat validation words test who who use python python use validation cat	training cat training cat validation words test who who use python python use validation cat
test python that words validation test validation who words who validation this test use who	test python that words validation test validation who words who validation this test use who
this that training that words training python cat python cat words cat python words use	this that training that words training python cat python cat words cat python words use
that that who this cat test cat use test use training cat that words training	that that who this cat test cat use test use training cat that words training
who training that python cat this cat use validation cat python training validation words test	who training that python cat this cat use validation cat python training validation words test
cat cat training words cat words validation this validation this cat this python python test	cat cat training words cat words validation this validation this cat this python python test
that use who who that cat use use cat this training who training words words	that use who who that cat use use cat this training who training words words
words who validation cat cat use training training that use training test test test who	words who validation cat cat use training training that use training test test test who
that validation training who validation who use words validation use cat training that validation validation	that validation training who validation who use words validation use cat training that validation validation
test use python cat cat validation python words use that test test words this use	test use python cat cat validation python words use that test test words this use
cat that python words use python words that that validation validation test test this test	cat that python words use python words that that validation validation test test this test
this words this training use this cat who training that use training test cat cat	this words this training use this cat who training that use training test cat cat
words test that cat that validation test cat python validation validation that this cat cat	words test that cat that validation test cat python validation validation that this cat cat
use cat test validation cat validation cat validation that cat words this cat validation cat	use cat test validation cat validation cat validation that cat words this cat validation cat
python python cat this this use test python use this who that words cat validation	python python cat this this use test python use this who that words cat validation
cat who that words cat cat python use use use training test test python cat	cat who that words cat cat python use use use training test test python cat
validation use cat validation cat that cat who validation who that that cat words cat	validation use cat validation cat that cat who validation who that that cat words cat
use test who validation who test that use python test that validation test this this	use test who validation who test that use python test that validation test this this
cat test training cat who training test cat who cat who validation use cat who	cat test training cat who training test cat who cat who validation use cat who
who python training that this words python use who that cat this training this cat	who python training that this words python use who that cat this training this cat
use training use this use python python training python cat validation test python cat python	use training use this use python python training python cat validation test python cat python
validation cat this cat words who training cat python validation cat that that this use	validation cat this cat words who training cat python validation cat that that this use
words that validation this that this that who test test python cat training that this	words that validation this that this that who test test python cat training that this
use who validation python cat words use cat words that that python this words that	use who validation python cat words use cat words that that python this words that
training python cat who that this training cat who cat this cat this training words	training python cat who that this training cat who cat this cat this training words
words validation that python who use python test use python python training use cat training	words validation that python who use python test use python python training use cat training
this validation training test cat python test that cat validation training test that python test	this validation training test cat python test that cat validation training test that python test
training who this training training use use python validation cat cat who words this words	training who this training training use use python validation cat cat who words this words
cat training training cat training words test validation who validation python cat who who training	cat training training cat training words test validation who validation python cat who who training
words cat python that python cat use who cat training training this words this use	words cat python that python cat use who cat training training this words this use
use validation cat words cat this words validation test test cat that training test training	use validation cat words cat this words validation test test cat that training test training
that that that training use validation this test training this test training words training training	that that that training use validation this test training this test training words training training
cat training use validation who cat cat training cat test who that use test that	cat training use validation who cat cat training cat test who that use test that
validation words this cat python training training this cat training training test that python words	validation words this cat python training training this cat training training test that python words
that cat cat words words who words python who cat use python python who cat	that cat cat words words who words python who cat use python python who cat
python test test python cat words python test validation test words validation words cat cat	python test test python cat words python test validation test words validation words cat cat
that cat test training cat python training words this cat this this words cat cat	that cat test training cat python training words this cat this this words cat cat
use validation cat that who validation cat cat test training cat cat this cat cat	use validation cat that who validation cat cat test training cat cat this cat cat
words words test validation cat validation python words that words training that this who words	words words test validation cat validation python words that words training that this who words
that cat use training use this who use python cat cat training python that cat	that cat use training use this who use python cat cat training python that cat
that this use this validation test use use use words training words test training python	that this use this validation test use use use words training words test training python
words validation that who cat who test cat test test words python cat python words	words validation that who cat who test cat test test words python cat python words
test that python python words training training test python python test this words cat words	test that python python words training training test python python test this words cat words
validation this use python cat validation python test this validation use cat who words training	validation this use python cat validation python test this validation use cat who words training
who validation validation cat python this python use test python test cat test use use	who validation validation cat python this python use test python test cat test use use
use cat cat use validation python python validation who use use python use this cat	use cat cat use validation python python validation who use use python use this cat
validation cat cat that test python use test that who cat cat training who this	validation cat cat that test python use test that who cat cat training who this
validation training use cat training that cat python cat cat python python who cat test	validation training use cat training that cat python cat cat python python who cat test
cat that that who that use use this words training validation training cat that cat	cat that that who that use use this words training validation training cat that cat
who words training that cat who python this this training cat test python python that	who words training that cat who python this this training cat test python python that
use cat python use test words training this test training validation cat cat who validation	use cat python use test words training this test training validation cat cat who validation
this validation validation training python use cat test use validation this who who test use	this validation validation training python use cat test use validation this who who test use
test this cat cat python who training this cat python python validation who python test	test this cat cat python who training this cat python python validation who python test
python this validation test cat test this who cat cat use test python who that	python this validation test cat test this who cat cat use test python who that
validation test test test cat who that use use validation test test cat who this	validation test test test cat who that use use validation test test cat who this
test this words use this python words who cat training python cat cat test python	test this words use this python words who cat training python cat cat test python
words use python who who python validation words that words cat cat words this training	words use python who who python validation words that words cat cat words this training
python cat that test that cat python validation that validation test validation test validation validation	python cat that test that cat python validation that validation test validation test validation validation
validation training test cat who that cat training training that words use test words who	validation training test cat who that cat training training that words use test words who
cat who cat cat python test training cat this who validation python who validation validation	cat who cat cat python test training cat this who validation python who validation validation
training cat cat test test cat use who who test test test validation validation use	training cat cat test test cat use who who test test test validation validation use
validation this who validation that test python python test words use that python use cat	validation this who validation that test python python test words use that python use cat
this who test test this who cat use that use this python this training cat	this who test test this who cat use that use this python this training cat
training this cat cat test that words use validation that validation python test python cat	training this cat cat test that words use validation that validation python test python cat
test training that validation validation cat test who cat that words who cat this validation	test training that validation validation cat test who cat that words who cat this validation
who test words test this words training validation training training who that use cat python	who test words test this words training validation training training who that use cat python
this test training this words that that words that validation who that cat words that	this test training this words that that words that validation who that cat words that
that use cat words cat who who python training training words validation words python python	that use cat words cat who who python training training words validation words python python
cat who who python training cat training that validation cat words words training use who	cat who who python training cat training that validation cat words words training use who
test that this that words cat who python that this words cat validation who cat	test that this that words cat who python that this words cat validation who cat
cat validation cat that use this use who use this who use test test that	cat validation cat that use this use who use this who use test test that
this who validation words that training training this who training test python this who who	this who validation words that training training this who training test python this who who
test training that python that python test cat validation python cat this cat this cat	test training that python that python test cat validation python cat this cat this cat
test python words training python cat cat cat cat cat cat use test training python	test python words training python cat cat cat cat cat cat use test training python
this that that cat that test cat python cat this cat cat who use training	this that that cat that test cat python cat this cat cat who use training
validation python cat test cat python python validation words python this python python training training	validation python cat test cat python python validation words python this python python training training
this words validation test training training test python training that who python that who training	this words validation test training training test python training that who python that who training
validation use words python python training cat this who cat cat this words python words	validation use words python python training cat this who cat cat this words python words
test validation test cat cat words this cat cat validation test cat this that python	test validation test cat cat words this cat cat validation test cat this that python
python cat validation who use who this test python that cat cat validation training who	python cat validation who use who this test python that cat cat validation training who
training who that cat this use validation use python cat use validation who use python	training who that cat this use validation use python cat use validation who use python
training who python this training cat training test who test who validation training validation this	training who python this training cat training test who test who validation training validation this
who this who python test python that test test that validation that cat this that	who this who python test python that test test that validation that cat this that
words use cat words python test validation this test words test words cat validation words	words use cat words python test validation this test words test words cat validation words
cat words validation cat words training that test cat use who cat who cat who	cat words validation cat words training that test cat use who cat who cat who
use use test training words cat cat words test that cat python that who validation	use use test training words cat cat words test that cat python that who validation
cat cat cat cat that that that that cat use training validation cat python who	cat cat cat cat that that that that cat use training validation cat python who
cat python use python words cat use training that use who use cat words use	cat python use python words cat use training that use who use cat words use
validation words training that who use validation training test use words python cat training test	validation words training that who use validation training test use words python cat training test
test training cat use use cat cat cat validation validation words validation validation cat python	test training cat use use cat cat cat validation validation words validation validation cat python
python words python test who cat cat cat validation use validation python test validation validation	python words python test who cat cat cat validation use validation python test validation validation
training cat validation python use who that cat cat words that cat that test words	training cat validation python use who that cat cat words that cat that test words
this this who cat validation that test training words this who cat words test this	this this who cat validation that test training words this who cat words test this
who this cat that this training this python cat who who python this use that	who this cat that this training this python cat who who python this use that
python cat training python cat words training who training validation test who cat test this	python cat training python cat words training who training validation test who cat test this
cat cat python cat test test test training test this who validation use who words	cat cat python cat test test test training test this who validation use who words
cat words cat test test python python training validation use words that test python words	cat words cat test test python python training validation use words that test python words
who validation this cat cat use validation python that python this cat words this python	who validation this cat cat use validation python that python this cat words this python
words training words validation cat use who who cat that words use use this that	words training words validation cat use who who cat that words use use this that
training this who that words training who words this training test test that this who	training this who that words training who words this training test test that this who
words this use words validation words who cat this cat training test who test words	words this use words validation words who cat this cat training test who test words
cat training test cat who that cat training cat python who that validation test test	cat training test cat who that cat training cat python who that validation test test
training training cat cat cat cat validation training who that that python use cat cat	training training cat cat cat cat validation training who that that python use cat cat
who validation who cat words use cat use this use test who that words validation	who validation who cat words use cat use this use test who that words validation
cat use that python use validation training test this that cat training cat cat python	cat use that python use validation training test this that cat training cat cat python
test words python use cat validation words cat python python cat python cat cat cat	test words python use cat validation words cat python python cat python cat cat cat
training that this words that test validation training use python cat use words words use	training that this words that test validation training use python cat use words words use
who cat use test training cat use python who words cat python python cat that	who cat use test training cat use python who words cat python python cat that
use test that python who that test cat test that python use this python who	use test that python who that test cat test that python use this python who
cat words python test use use words who validation cat who python that cat use	cat words python test use use words who validation cat who python that cat use
use use who who who test that validation use that words cat cat cat cat	use use who who who test that validation use that words cat cat cat cat
python python this cat use cat training cat that use test validation who cat cat	python python this cat use cat training cat that use test validation who cat cat
words training use this training words use cat validation python this cat cat validation words	words training use this training words use cat validation python this cat cat validation words
test this words validation python words use words this that who who words cat cat	test this words validation python words use words this that who who words cat cat
cat training test use training cat cat cat cat that validation training cat words test	cat training test use training cat cat cat cat that validation training cat words test
that cat words who that that python this cat who this that this validation cat	that cat words who that that python this cat who this that this validation cat
who use cat python cat this that cat cat cat words python training words training	who use cat python cat this that cat cat cat words python training words training
validation training python cat cat use use that python who cat who validation this test	validation training python cat cat use use that python who cat who validation this test
training training validation test validation test that words training cat cat python who cat use	training training validation test validation test that words training cat cat python who cat use
test cat test who use cat cat who training training words this words validation who	test cat test who use cat cat who training training words this words validation who
who validation cat validation python this cat this who training cat who this test use	who validation cat validation python this cat this who training cat who this test use
words cat test who this python use who words that test who python use validation	words cat test who this python use who words that test who python use validation
who python use validation use use cat training cat who this cat test that cat	who python use validation use use cat training cat who this cat test that cat
training words that this words use training use use test use cat cat this test	training words that this words use training use use test use cat cat this test
training cat use this validation this that validation this training words cat validation training validation	training cat use this validation this that validation this training words cat validation training validation
words cat use test words cat test cat use that cat words training this python	words cat use test words cat test cat use that cat words training this python
validation test python cat python that python cat training use test that cat who test	validation test python cat python that python cat training use test that cat who test
cat use python training cat validation use use words cat use python this validation use	cat use python training cat validation use use words cat use python this validation use
this who cat python training validation test who python python words validation cat cat who	this who cat python training validation test who python python words validation cat cat who
that this words cat validation this this training python that use test words cat cat	that this words cat validation this this training python that use test words cat cat
python words this test cat use that validation who cat test python cat use words	python words this test cat use that validation who cat test python cat use words
python use validation use test training training cat validation validation python who who training who	python use validation use test training training cat validation validation python who who training who
training cat cat test validation python who use training that this this test cat test	training cat cat test validation python who use training that this this test cat test
words that words this validation cat words words who who who use that words training	words that words this validation cat words words who who who use that words training
python python validation cat python that use training training this this cat words validation this	python python validation cat python that use training training this this cat words validation this
cat that test test this validation cat that cat use who training cat test who	cat that test test this validation cat that cat use who training cat test who
python validation cat cat cat cat cat words cat validation validation that validation test python	python validation cat cat cat cat cat words cat validation validation that validation test python
test that training this cat test use this python this python that that words who	test that training this cat test use this python this python that that words who
validation use cat python test that that training cat validation use this test training who	validation use cat python test that that training cat validation use this test training who
cat words that use test python python validation training cat who use use validation use	cat words that use test python python validation training cat who use use validation use
that cat cat that test cat python cat validation cat use cat this python that	that cat cat that test cat python cat validation cat use cat this python that
python test use who words training who use cat words cat training words python this	python test use who words training who use cat words cat training words python this
cat this test cat cat test that cat that validation training this this validation validation	cat this test cat cat test that cat that validation training this this validation validation
test cat validation words words that this use python training python who validation cat cat	test cat validation words words that this use python training python who validation cat cat
use cat training that training cat training use cat validation test that cat test who	use cat training that training cat training use cat validation test that cat test who
python use cat validation that this validation who words training training cat that use words	python use cat validation that this validation who words training training cat that use words
that test use cat cat python use cat this validation test python cat who words	that test use cat cat python use cat this validation test python cat who words
who use training use that training validation use this test this use training cat who	who use training use that training validation use this test this use training cat who
use that use cat validation that use python that cat test validation this test validation	use that use cat validation that use python that cat test validation this test validation
cat that test who cat that test who cat this this training that that test	cat that test who cat that test who cat this this training that that test
words validation python test training this this use cat that validation this who validation training	words validation python test training this this use cat that validation this who validation training
this python this training cat who use validation test who cat use test cat words	this python this training cat who use validation test who cat use test cat words
cat use cat this training cat test this words words cat who use training words	cat use cat this training cat test this words words cat who use training words
python this training words that validation training cat cat python test use validation use use	python this training words that validation training cat cat python test use validation use use
this validation cat who cat test python this who use words words test python this	this validation cat who cat test python this who use words words test python this
this use words validation who training python test training python test test who who test	this use words validation who training python test training python test test who who test
training this validation cat words test this who words use python cat who use words	training this validation cat words test this who words use python cat who use words
use cat this who test cat cat python words python python validation python test validation	use cat this who test cat cat python words python python validation python test validation
words cat validation cat words who cat words this training who cat words that python	words cat validation cat words who cat words this training who cat words that python
words who this training python validation python cat training cat that cat validation cat words	words who this training python validation python cat training cat that cat validation cat words
this python who this cat that words cat words validation training that this cat test	this python who this cat that words cat words validation training that this cat test
use who cat this cat words that validation use validation test cat cat test that	use who cat this cat words that validation use validation test cat cat test that
who training who that training use python validation validation cat use use use training test	who training who that training use python validation validation cat use use use training test
validation use python who test test test use use use who cat test use validation	validation use python who test test test use use use who cat test use validation
words that python python python training use training python validation words this cat who python	words that python python python training use training python validation words this cat who python
words python python python that cat this validation use cat cat validation this cat test	words python python python that cat this validation use cat cat validation this cat test
this validation validation words validation test python this validation that this that who training words	this validation validation words validation test python this validation that this that who training words
training this who training cat cat cat this who test words python cat this who	training this who training cat cat cat this who test words python cat this who
test that this this who test who use test that cat that training cat validation	test that this this who test who use test that cat that training cat validation
words training validation this who cat use words this this that cat who cat that	words training validation this who cat use words this this that cat who cat that
validation validation who test training use cat that training this python cat training cat cat	validation validation who test training use cat that training this python cat training cat cat
this who who use training who cat validation this who python this training words this	this who who use training who cat validation this who python this training words this
who cat that validation use cat words cat test cat cat cat python this words	who cat that validation use cat words cat test cat cat cat python this words
validation who python this test who validation cat words this training that python this this	validation who python this test who validation cat words this training that python this this
python use cat cat training who python words training this use words python words test	python use cat cat training who python words training this use words python words test
who cat this python python cat who who training who cat training who python who	who cat this python python cat who who training who cat training who python who
python training cat cat use that this words use python training who test use training	python training cat cat use that this words use python training who test use training
this words validation cat use this training that that cat training this test this cat	this words validation cat use this training that that cat training this test this cat
cat that this who python use cat validation cat python that cat that who cat	cat that this who python use cat validation cat python that cat that who cat
cat that use training who who who validation who validation words validation words that use	cat that use training who who who validation who validation words validation words that use
who validation training use use cat python words use cat cat training cat training who	who validation training use use cat python words use cat cat training cat training who
training that that use that words who training training python that words words cat cat	training that that use that words who training training python that words words cat cat
test cat validation words cat training training this test that validation use training cat who	test cat validation words cat training training this test that validation use training cat who
that words validation who words that this test training test test validation words test cat	that words validation who words that this test training test test validation words test cat
cat training training training this use python cat python use cat training this use use	cat training training training this use python cat python use cat training this use use
who who this training training words that this test python who this words python training	who who this training training words that this test python who this words python training
cat cat training use cat training words validation that that python who this this this	cat cat training use cat training words validation that that python who this this this
test who cat that cat python that python use words use python who use that	test who cat that cat python that python use words use python who use that
that validation cat python that python cat use that validation training test python test who	that validation cat python that python cat use that validation training test python test who
python validation python test validation this validation use test that who cat cat who cat	python validation python test validation this validation use test that who cat cat who cat
cat cat use use use cat words who this python cat python cat test cat	cat cat use use use cat words who this python cat python cat test cat
use who this words python python python who who who training this that training python	use who this words python python python who who who training this that training python
training python training this words this words validation this use this who words cat words	training python training this words this words validation this use this who words cat words
that use cat training who use that cat training that that words cat who who	that use cat training who use that cat training that that words cat who who
words cat validation that test python words who that test use validation that words this	words cat validation that test python words who that test use validation that words this
cat that words cat python use python cat python this validation cat who use this	cat that words cat python use python cat python this validation cat who use this
training python cat test that cat who who training use words use who words that	training python cat test that cat who who training use words use who words that
python test who validation this training cat who cat python test validation python that cat	python test who validation this training cat who cat python test validation python that cat
words cat that use test cat words words test python use use validation training that	words cat that use test cat words words test python use use validation training that
words words this validation validation that training cat words validation validation words test validation words	words words this validation validation that training cat words validation validation words test validation words
cat this this words python words cat training cat cat cat words cat validation this	cat this this words python words cat training cat cat cat words cat validation this
training python that who use training that words cat words words validation test cat use	training python that who use training that words cat words words validation test cat use
cat who that use words words that test python cat validation validation this cat this	cat who that use words words that test python cat validation validation this cat this
who words who this cat cat python training who validation words this cat training training	who words who this cat cat python training who validation words this cat training training
this validation that cat test cat test that use words cat training use cat training	this validation that cat test cat test that use words cat training use cat training
test who this cat python use that this python use that use cat validation validation	test who this cat python use that this python use that use cat validation validation
validation use words validation who cat this who who python that words validation python who	validation use words validation who cat this who who python that words validation python who
who python validation python use test cat this use cat cat cat test validation use	who python validation python use test cat this use cat cat cat test validation use
test use that cat use use who python cat words validation validation who use words	test use that cat use use who python cat words validation validation who use words
this training cat this cat cat cat validation words test cat words words words cat	this training cat this cat cat cat validation words test cat words words words cat
cat python use validation validation cat that use who cat use validation training python validation	cat python use validation validation cat that use who cat use validation training python validation
training that validation this that that this cat that cat python that validation that who	training that validation this that that this cat that cat python that validation that who
who cat who python test training who cat words words cat this that words this	who cat who python test training who cat words words cat this that words this
validation test who cat words cat use python this this test use validation words this	validation test who cat words cat use python this this test use validation words this
this words who this training use validation words that this cat use cat cat cat	this words who this training use validation words that this cat use cat cat cat
cat this this this words this words this who python this cat words that validation	cat this this this words this words this who python this cat words that validation
cat validation that use use this who this who words python cat python validation python	cat validation that use use this who this who words python cat python validation python
use test that that training python training who cat test test that cat this cat	use test that that training python training who cat test test that cat this cat
validation who words training python cat who cat cat cat validation validation test this use	validation who words training python cat who cat cat cat validation validation test this use
that validation that cat training test that cat training test python words python test words	that validation that cat training test that cat training test python words python test words
who training that training that this cat python validation test cat cat training use who	who training that training that this cat python validation test cat cat training use who
use cat that test who words that cat python that python words words that words	use cat that test who words that cat python that python words words that words
words words test test use python this words this use cat use who python cat	words words test test use python this words this use cat use who python cat
test test this this training words use words cat test python that training training validation	test test this this training words use words cat test python that training training validation
test validation test this cat words use who who cat that who this who who	test validation test this cat words use who who cat that who this who who
cat that python words use words that that cat test cat cat use cat cat	cat that python words use words that that cat test cat cat use cat cat
cat that words this that python that training test training python who training this validation	cat that words this that python that training test training python who training this validation
test that that validation use test cat that validation test test words this validation validation	test that that validation use test cat that validation test test words this validation validation
validation cat test training training training cat training validation words who validation training training test	validation cat test training training training cat training validation words who validation training training test
use cat validation training cat who use test validation words test cat python words cat	use cat validation training cat who use test validation words test cat python words cat
python this who that use use words validation test cat this this this this cat	python this who that use use words validation test cat this this this this cat
who training validation words cat that words test training that that test cat words cat	who training validation words cat that words test training that that test cat words cat
validation python validation that validation this training that cat validation use python that cat that	validation python validation that validation this training that cat validation use python that cat that
this python test this test validation who that this cat this cat training who who	this python test this test validation who that this cat this cat training who who
who words this validation python use validation cat words words test use training test test	who words this validation python use validation cat words words test use training test test
that cat cat training training use words python cat this training training words that this	that cat cat training training use words python cat this training training words that this
use python use this test this validation words use test cat validation python this use	use python use this test this validation words use test cat validation python this use
this validation python validation cat use validation cat cat this words that who validation this	this validation python validation cat use validation cat cat this words that who validation this
training validation cat who that cat validation cat cat python words who this use cat	training validation cat who that cat validation cat cat python words who this use cat
use words training that use cat that python this this this that who use cat	use words training that use cat that python this this this that who use cat
python test who training this training words cat this python this this cat this validation	python test who training this training words cat this python this this cat this validation
this test who training training words who who words python who cat test cat use	this test who training training words who who words python who cat test cat use
who words cat python who words who training cat words python training python python words	who words cat python who words who training cat words python training python python words
words test validation that that this this cat use who test test validation test who	words test validation that that this this cat use who test test validation test who
that validation training training cat training this cat that python cat cat training validation training	that validation training training cat training this cat that python cat cat training validation training
that validation training python cat use cat validation training use python words that words cat	that validation training python cat use cat validation training use python words that words cat
use this test that who that training words cat python use training use who cat	use this test that who that training words cat python use training use who cat
that python words use cat that validation validation cat test cat use cat that training	that python words use cat that validation validation cat test cat use cat that training
training words who use training this that cat words test validation words python this use	training words who use training this that cat words test validation words python this use
words training python words python this python python this validation test cat training that this	words training python words python this python python this validation test cat training that this
use validation use who training training python that this who python python use training cat	use validation use who training training python that this who python python use training cat
training this validation test use that who cat cat cat training validation cat this cat	training this validation test use that who cat cat cat training validation cat this cat
who python use test cat training use training cat validation this test cat python training	who python use test cat training use training cat validation this test cat python training
python test who cat cat that that words who cat training validation use this this	python test who cat cat that that words who cat training validation use this this
cat training that training use use who validation python words words that words who training	cat training that training use use who validation python words words that words who training
cat test validation test cat python training training this that cat python that words this	cat test validation test cat python training training this that cat python that words this
python validation validation cat training words training cat training test training test who training cat	python validation validation cat training words training cat training test training test who training cat
this training who training cat cat python who use cat cat use training training test	this training who training cat cat python who use cat cat use training training test
cat validation words python training training training validation words python validation cat who this python	cat validation words python training training training validation words python validation cat who this python
who test that training cat test this test use that that cat this this validation	who test that training cat test this test use that that cat this this validation
validation test words who that test python python this this test that that python test	validation test words who that test python python this this test that that python test
cat use python training words this test python validation this who test this that python	cat use python training words this test python validation this who test this that python
python cat that this cat cat cat use words python validation that that this test	python cat that this cat cat cat use words python validation that that this test
training this validation test words words that words cat this training use that cat cat	training this validation test words words that words cat this training use that cat cat
validation use training use words cat cat validation test this cat validation cat python training	validation use training use words cat cat validation test this cat validation cat python training
that test validation words who this words this this use test who cat training that	that test validation words who this words this this use test who cat training that
that cat training python that cat test that python test cat that training validation words	that cat training python that cat test that python test cat that training validation words
this training cat that this python who words python use who who python cat cat	this training cat that this python who words python use who who python cat cat
words who that training training words cat words training words use cat python this training	words who that training training words cat words training words use cat python this training
training cat cat words cat python training who python words test cat cat cat this	training cat cat words cat python training who python words test cat cat cat this
cat training cat python training training python use python test cat test words test test	cat training cat python training training python use python test cat test words test test
this training training words cat validation words training use words use this python who training	this training training words cat validation words training use words use this python who training
who that who use cat python test use test this validation that words that cat	who that who use cat python test use test this validation that words that cat
this this words training this that training cat that validation words that python use that	this this words training this that training cat that validation words that python use that
validation use that this this that python this this cat that that who cat who	validation use that this this that python this this cat that that who cat who
words that that that use words cat training test training words this training test test	words that that that use words cat training test training words this training test test
who use test who that cat training cat use python validation this who validation words	who use test who that cat training cat use python validation this who validation words
use words training this words test validation training validation python cat validation test this training	use words training this words test validation training validation python cat validation test this training
who python cat test words python use python this validation validation cat use who this	who python cat test words python use python this validation validation cat use who this
who training python cat test this words training validation training test this this words validation	who training python cat test this words training validation training test this this words validation
python training this use training cat who test validation use test who words validation cat	python training this use training cat who test validation use test who words validation cat
python python cat words this cat test cat use who cat cat use test python	python python cat words this cat test cat use who cat cat use test python
cat cat use words cat cat that words python this use use test that words	cat cat use words cat cat that words python this use use test that words
who words words that use cat that cat training use training use that words use	who words words that use cat that cat training use training use that words use
training cat use words test test cat who words python who test that who test	training cat use words test test cat who words python who test that who test
words this this validation use cat use this this training training training words use validation	words this this validation use cat use this this training training training words use validation
that python test training cat cat validation this that use this validation that that use	that python test training cat cat validation this that use this validation that that use
training that python that validation validation who this training cat cat words who test that	training that python that validation validation who this training cat cat words who test that
test python training who validation python this cat test test words words cat python cat	test python training who validation python this cat test test words words cat python cat
use cat python validation who training cat python training this test python validation validation use	use cat python validation who training cat python training this test python validation validation use
use cat who words training who python cat words python this use who words cat	use cat who words training who python cat words python this use who words cat
that training who words cat python python that python cat cat that test words cat	that training who words cat python python that python cat cat that test words cat
test that training test python cat use python cat words python cat who cat use	test that training test python cat use python cat words python cat who cat use
use validation this words this validation validation cat cat cat cat words python this validation	use validation this words this validation validation cat cat cat cat words python this validation
that who use who words that cat use python test validation words test cat cat	that who use who words that cat use python test validation words test cat cat
validation who this that cat use validation validation test python this test cat who this	validation who this that cat use validation validation test python this test cat who this
words training use who this cat that cat words words python that test validation training	words training use who this cat that cat words words python that test validation training
this cat that that who use validation words words python cat who that this cat	this cat that that who use validation words words python cat who that this cat
that cat this use cat words python training who use validation words who cat that	that cat this use cat words python training who use validation words who cat that
who python this cat this words who training who validation words python training use training	who python this cat this words who training who validation words python training use training
training cat test words test that cat cat use training training training python python training	training cat test words test that cat cat use training training training python python training
who test cat validation test cat this test use cat cat validation cat who that	who test cat validation test cat this test use cat cat validation cat who that
cat words who words cat cat python validation cat validation words test that validation python	cat words who words cat cat python validation cat validation words test that validation python
validation python cat cat cat this python validation validation who cat cat cat use this	validation python cat cat cat this python validation validation who cat cat cat use this
validation validation use this who words python python python words validation cat words test this	validation validation use this who words python python python words validation cat words test this
cat words use who use words cat training that cat this this cat cat who	cat words use who use words cat training that cat this this cat cat who
this cat training validation words test words who cat python who words words validation test	this cat training validation words test words who cat python who words words validation test
test this that python validation test who use this this validation training use python test	test this that python validation test who use this this validation training use python test
python python training who that python use this that cat validation use validation validation validation	python python training who that python use this that cat validation use validation validation validation
use training cat validation this use python test that that that words this this cat	use training cat validation this use python test that that that words this this cat
who cat who that validation that who python cat training test python use this test	who cat who that validation that who python cat training test python use this test
this who validation this cat who validation cat that validation python this cat words training	this who validation this cat who validation cat that validation python this cat words training
validation test that validation use words cat training python test python use words that validation	validation test that validation use words cat training python test python use words that validation
training cat cat cat who training test python training words this this use cat use	training cat cat cat who training test python training words this this use cat use
words cat this cat test use who cat cat cat use cat test words validation	words cat this cat test use who cat cat cat use cat test words validation
python use words use test use this that this training use validation that cat this	python use words use test use this that this training use validation that cat this
cat validation use test who cat python validation validation who who python that training words	cat validation use test who cat python validation validation who who python that training words
training python who use cat python who this who python who words cat test validation	training python who use cat python who this who python who words cat test validation
this validation words use cat python that training cat cat cat training validation cat cat	this validation words use cat python that training cat cat cat training validation cat cat
words validation cat test validation words words use python training training test use python python	words validation cat test validation words words use python training training test use python python
validation cat python cat test this cat python cat python this who cat this training	validation cat python cat test this cat python cat python this who cat this training
who test cat words words who training test training python cat that cat cat cat	who test cat words words who training test training python cat that cat cat cat
cat this training use use cat who that cat validation validation words this cat validation	cat this training use use cat who that cat validation validation words this cat validation
words test python validation training words test test python test training this test cat cat	words test python validation training words test test python test training this test cat cat
that cat cat words training words who who cat cat test this use cat words	that cat cat words training words who who cat cat test this use cat words
use test cat that cat validation validation training use validation training validation who cat cat	use test cat that cat validation validation training use validation training validation who cat cat
test cat training training words training that use use use cat python cat training validation	test cat training training words training that use use use cat python cat training validation
validation this training words training use that that test this use who words words validation	validation this training words training use that that test this use who words words validation
who python cat training cat cat test cat words who words cat words python training	who python cat training cat cat test cat words who words cat words python training
training who use words words cat words python test cat words who cat training cat	training who use words words cat words python test cat words who cat training cat
cat python use python this test this python training this python python this test words	cat python use python this test this python training this python python this test words
training validation validation this training who who who training cat use who who cat validation	training validation validation this training who who who training cat use who who cat validation
training use that who words python words use cat cat this who test cat training	training use that who words python words use cat cat this who test cat training
who who validation test who who cat use that that cat cat use cat this	who who validation test who who cat use that that cat cat use cat this
cat words python words cat words use python cat words words python who words this	cat words python words cat words use python cat words words python who words this
this python this training that test python who python that words cat training words validation	this python this training that test python who python that words cat training words validation
training cat that python this test words this that use this words python cat words	training cat that python this test words this that use this words python cat words
training who test training cat that words who validation cat test this cat use use	training who test training cat that words who validation cat test this cat use use
use validation words python this words training validation cat that python use that this that	use validation words python this words training validation cat that python use that this that
python this training cat cat test that that test this that who python this validation	python this training cat cat test that that test this that who python this validation
use training training test who this test validation that test this this test training cat	use training training test who this test validation that test this this test training cat
training validation cat validation use cat python training validation python validation cat training cat who	training validation cat validation use cat python training validation python validation cat training cat who
cat cat cat test words who words words test this validation training test who cat	cat cat cat test words who words words test this validation training test who cat
cat this this who cat who this words python use use python this use cat	cat this this who cat who this words python use use python this use cat
validation that use words training test this test who test use that this python who	validation that use words training test this test who test use that this python who
test validation cat cat python training that cat validation words that this who validation use	test validation cat cat python training that cat validation words that this who validation use
training validation cat that validation training use validation cat cat cat words use validation python	training validation cat that validation training use validation cat cat cat words use validation python
cat this words words use cat that cat that cat test test python test cat	cat this words words use cat that cat that cat test test python test cat
test this training that use cat this this use training that training python that use	test this training that use cat this this use training that training python that use
cat training cat cat who use this this test that that test python training cat	cat training cat cat who use this this test that that test python training cat
use test cat python this cat cat python test use validation validation who validation use	use test cat python this cat cat python test use validation validation who validation use
this test that that words use that who validation validation use words this test this	this test that that words use that who validation validation use words this test this
test test validation that cat cat python training cat that that this validation test training	test test validation that cat cat python training cat that that this validation test training
words validation training use cat test cat words python use validation who python that use	words validation training use cat test cat words python use validation who python that use
validation cat cat validation who validation words cat that use cat cat cat test python	validation cat cat validation who validation words cat that use cat cat cat test python
words test who training this this validation training cat words training training use cat test	words test who training this this validation training cat words training training use cat test
test cat training who python cat python test validation training python validation who who who	test cat training who python cat python test validation training python validation who who who
that that test that training validation that words python who cat use words that that	that that test that training validation that words python who cat use words that that
cat test this that test cat python use training that that test python who cat	cat test this that test cat python use training that that test python who cat
cat that training use that who python use validation that cat test validation that validation	cat that training use that who python use validation that cat test validation that validation
this cat words this words use that this cat cat python python cat test words	this cat words this words use that this cat cat python python cat test words
validation who who that validation training words that this who cat use validation words python	validation who who that validation training words that this who cat use validation words python
training cat that validation use training training who test words validation that validation use validation	training cat that validation use training training who test words validation that validation use validation
this test use python who training cat this use cat who that python training use	this test use python who training cat this use cat who that python training use
who that cat cat use test validation who cat use words this that this cat	who that cat cat use test validation who cat use words this that this cat
that that cat cat test training cat validation that python python use test training python	that that cat cat test training cat validation that python python use test training python
validation who that python validation cat who cat that python cat use who words test	validation who that python validation cat who cat that python cat use who words test
validation test validation python python who validation use that this cat use use cat validation	validation test validation python python who validation use that this cat use use cat validation
training use who test that cat who cat python this that words cat this who	training use who test that cat who cat python this that words cat this who
use who cat cat training test cat use use test cat use use training test	use who cat cat training test cat use use test cat use use training test
test validation validation training use validation words training validation test test cat this cat this	test validation validation training use validation words training validation test test cat this cat this
validation cat validation test cat this who cat validation cat use this python words python	validation cat validation test cat this who cat validation cat use this python words python
that cat this test this this python use validation test use training this use words	that cat this test this this python use validation test use training this use words
who training words this who test that validation cat cat python cat test validation this	who training words this who test that validation cat cat python cat test validation this
cat python who use test cat words cat training who training cat use who that	cat python who use test cat words cat training who training cat use who that
who test python cat this python test validation use python that test words cat use	who test python cat this python test validation use python that test words cat use
python who who cat that this this words use words validation validation that who validation	python who who cat that this this words use words validation validation that who validation
cat python who who who use test words words python who use use python python	cat python who who who use test words words python who use use python python
use words python python cat that validation that cat this this this cat validation who	use words python python cat that validation that cat this this this cat validation who
training words cat python use cat validation cat validation use cat test this use cat	training words cat python use cat validation cat validation use cat test this use cat
use words who test training python who cat test words words use validation validation this	use words who test training python who cat test words words use validation validation this
this validation words words words that python training who validation use that who who cat	this validation words words words that python training who validation use that who who cat
that this that this validation that cat cat test validation use who who test cat	that this that this validation that cat cat test validation use who who test cat
validation cat who use that training test test cat test python training use use words	validation cat who use that training test test cat test python training use use words
test training cat test cat cat cat that use cat python use cat this that	test training cat test cat cat cat that use cat python use cat this that
training training who who words cat cat that cat this validation test this test use	training training who who words cat cat that cat this validation test this test use
validation cat test who cat test validation use who validation this test validation training training	validation cat test who cat test validation use who validation this test validation training training
cat validation who validation who who this python who cat this words validation who test	cat validation who validation who who this python who cat this words validation who test
words cat words validation who that that that training who cat who who python who	words cat words validation who that that that training who cat who who python who
who training training python cat test who that python cat python words that cat cat	who training training python cat test who that python cat python words that cat cat
that this that who who validation that use that use use cat this cat who	that this that who who validation that use that use use cat this cat who
that python use test cat that cat training use validation validation who training that validation	that python use test cat that cat training use validation validation who training that validation
training python test training python training cat that cat use test cat python who python	training python test training python training cat that cat use test cat python who python
that cat this words validation words words python test that this this use training words	that cat this words validation words words python test that this this use training words
use who who that validation cat this who cat cat cat who words validation this	use who who that validation cat this who cat cat cat who words validation this
that python this this words who cat cat python training this cat training cat training	that python this this words who cat cat python training this cat training cat training
words validation cat training that validation validation cat words this who this this who test	words validation cat training that validation validation cat words this who this this who test
validation training validation use validation cat python cat that words cat validation that cat use	validation training validation use validation cat python cat that words cat validation that cat use
test use that words who training validation cat cat who words validation who training use	test use that words who training validation cat cat who words validation who training use
training python cat who this who test training that cat cat this that words who	training python cat who this who test training that cat cat this that words who
test use that use this cat words use who test use python cat validation python	test use that use this cat words use who test use python cat validation python
training that who validation python validation words validation validation test training cat validation use this	training that who validation python validation words validation validation test training cat validation use this
cat python words python words this this training words who validation cat validation python this	cat python words python words this this training words who validation cat validation python this
use validation who validation cat that training python cat python test that who this who	use validation who validation cat that training python cat python test that who this who
cat validation cat python training this use cat this that training training cat cat training	cat validation cat python training this use cat this that training training cat cat training
this cat who validation cat python cat cat use python validation cat use training cat	this cat who validation cat python cat cat use python validation cat use training cat
validation training validation cat test use words python training that training that test cat test	validation training validation cat test use words python training that training that test cat test
use cat this words python words test training use that this words validation use cat	use cat this words python words test training use that this words validation use cat
who words cat training validation words python cat that that that this training cat words	who words cat training validation words python cat that that that this training cat words
words words cat training that validation who python python validation use test this words python	words words cat training that validation who python python validation use test this words python
validation python validation this this python test training use that words validation python validation this	validation python validation this this python test training use that words validation python validation this
cat cat who use who training this cat cat who this who who words cat	cat cat who use who training this cat cat who this who who words cat
that who use python test use training that who validation that this who this use	that who use python test use training that who validation that this who this use
training validation cat training test validation use training words words cat cat use validation python	training validation cat training test validation use training words words cat cat use validation python
who words python use cat validation this use use that test words cat cat cat	who words python use cat validation this use use that test words cat cat cat
use cat python test python who who validation words that validation python test training cat	use cat python test python who who validation words that validation python test training cat
python use that this test cat who cat test who test cat this training cat	python use that this test cat who cat test who test cat this training cat
who python who test validation words words use this training this python that use training	who python who test validation words words use this training this python that use training
test who this this cat cat python training test this cat cat words training test	test who this this cat cat python training test this cat cat words training test
words cat test test test words who test words cat this cat cat test training	words cat test test test words who test words cat this cat cat test training
training python this that validation that that that python test training who cat who cat	training python this that validation that that that python test training who cat who cat
python validation that cat who use python cat test python words that this words test	python validation that cat who use python cat test python words that this words test
this training cat validation cat test python test who that training cat this python training	this training cat validation cat test python test who that training cat this python training
python cat test that who words python use cat validation that that this test test	python cat test that who words python use cat validation that that this test test
test python training training validation words that training use test test that words cat cat	test python training training validation words that training use test test that words cat cat
cat who training that cat who validation use training test use words this python test	cat who training that cat who validation use training test use words this python test
python training validation who that who this test words that cat training cat use cat	python training validation who that who this test words that cat training cat use cat
this python words cat who words this validation cat words cat validation cat that test	this python words cat who words this validation cat words cat validation cat that test
words this this training validation cat cat words that cat words use training that who	words this this training validation cat cat words that cat words use training that who
python this python test that training cat that that use this words this training that	python this python test that training cat that that use this words this training that
who use cat this that use this words test this cat cat that training cat	who use cat this that use this words test this cat cat that training cat
this words who test this that cat python test test test this that validation use	this words who test this that cat python test test test this that validation use
python test training test who cat test use cat training who who python this cat	python test training test who cat test use cat training who who python this cat
this that use validation cat use validation python cat cat training words cat validation validation	this that use validation cat use validation python cat cat training words cat validation validation
training who cat cat cat that that test cat use python this test words that	training who cat cat cat that that test cat use python this test words that
python use who validation cat words that this that use that cat training python this	python use who validation cat words that this that use that cat training python this
test use training python who test use words python cat python who training validation cat	test use training python who test use words python cat python who training validation cat
this who that cat python that this python cat cat training test words that words	this who that cat python that this python cat cat training test words that words
cat who use python this this python training words test words that this words training	cat who use python this this python training words test words that this words training
validation words cat this test words validation words use use words training test this words	validation words cat this test words validation words use use words training test this words
validation cat test this training cat validation this who training training that words training validation	validation cat test this training cat validation this who training training that words training validation
who cat cat validation test python words who training use who who python who cat	who cat cat validation test python words who training use who who python who cat
who python use this use who words that that test test cat test cat cat	who python use this use who words that that test test cat test cat cat
who validation validation use cat test who validation words that validation validation training words who	who validation validation use cat test who validation words that validation validation training words who
validation test that who validation validation cat that cat python words this that test training	validation test that who validation validation cat that cat python words this that test training
cat python that cat this that validation test use cat use cat python test validation	cat python that cat this that validation test use cat use cat python test validation
this use training cat cat this use validation validation validation validation python training this cat	this use training cat cat this use validation validation validation validation python training this cat
cat this that test python cat use use test validation who cat validation cat python	cat this that test python cat use use test validation who cat validation cat python
words training training python test who who cat test use cat test words python test	words training training python test who who cat test use cat test words python test
training who this training test validation words who who python words use cat cat that	training who this training test validation words who who python words use cat cat that
python who words that cat python cat this validation cat cat that words words cat	python who words that cat python cat this validation cat cat that words words cat
that that cat use training test words python that who that words who validation training	that that cat use training test words python that who that words who validation training
words cat who validation cat that this validation python use training use python training who	words cat who validation cat that this validation python use training use python training who
this cat use that use test test words cat validation that cat that use use	this cat use that use test test words cat validation that cat that use use
validation cat training use use words cat this python use this words python this test	validation cat training use use words cat this python use this words python this test
cat who words cat words use validation that words this validation cat words training test	cat who words cat words use validation that words this validation cat words training test
use test that python test validation validation cat validation test this python cat who validation	use test that python test validation validation cat validation test this python cat who validation
that cat who python training cat that that test this who that cat this cat	that cat who python training cat that that test this who that cat this cat
that python words test use use validation test validation this python this that python this	that python words test use use validation test validation this python this that python this
use cat words python python test use who test python who python validation this training	use cat words python python test use who test python who python validation this training
words use who this use who use cat cat test use python this test that	words use who this use who use cat cat test use python this test that
validation cat this cat use test this validation words python words cat that words validation	validation cat this cat use test this validation words python words cat that words validation
cat training cat words who python words python use test python words who cat python	cat training cat words who python words python use test python words who cat python
who test cat cat use this python cat that use python use words who cat	who test cat cat use this python cat that use python use words who cat
python use training who cat cat that that python validation words test test validation test	python use training who cat cat that that python validation words test test validation test
test training that that cat words who cat python use python validation validation validation that	test training that that cat words who cat python use python validation validation validation that
who that cat this that who validation cat who this test python python that that	who that cat this that who validation cat who this test python python that that
this training training who words validation cat python validation this that test python use training	this training training who words validation cat python validation this that test python use training
this who cat who test training use this training cat python cat this cat cat	this who cat who test training use this training cat python cat this cat cat
who python test that cat who test training words words this training training use test	who python test that cat who test training words words this training training use test
words use validation that cat validation cat cat python training that training test test cat	words use validation that cat validation cat cat python training that training test test cat
who that test test training cat test test words who training cat test who cat	who that test test training cat test test words who training cat test who cat
cat training test validation cat test test that words cat that cat test who use	cat training test validation cat test test that words cat that cat test who use
this validation that words who python cat this words cat this python cat that that	this validation that words who python cat this words cat this python cat that that
training python this training this this validation that words cat cat this training training who	training python this training this this validation that words cat cat this training training who
who cat cat words words that cat cat who that cat cat use test test	who cat cat words words that cat cat who that cat cat use test test
cat python validation that that this cat who validation that cat validation that test cat	cat python validation that that this cat who validation that cat validation that test cat
python that python cat use use python that validation cat that validation cat that test	python that python cat use use python that validation cat that validation cat that test
this validation that that test words test test use validation this test who cat python	this validation that that test words test test use validation this test who cat python
cat python words cat this python that cat cat test training test who validation words	cat python words cat this python that cat cat test training test who validation words
who that that this validation python test that training cat who cat validation that training	who that that this validation python test that training cat who cat validation that training
this that validation words cat test validation training training validation cat words that this use	this that validation words cat test validation training training validation cat words that this use
training words python cat validation validation python this cat words that this words validation training	training words python cat validation validation python this cat words that this words validation training
python training that words test this validation words cat this that cat training that cat	python training that words test this validation words cat this that cat training that cat
python cat words this that that that this training python cat cat words validation test	python cat words this that that that this training python cat cat words validation test
python words cat this words words training python training python test training test python that	python words cat this words words training python training python test training test python that
cat who test words who use training training cat training training that this use cat	cat who test words who use training training cat training training that this use cat
python cat training test that validation cat python that cat this who python that python	python cat training test that validation cat python that cat this who python that python
cat who validation training training cat words that words words who cat validation validation python	cat who validation training training cat words that words words who cat validation validation python
cat words training training who training this that training python test python use this this	cat words training training who training this that training python test python use this this
that python test python this who validation cat that test cat who that validation test	that python test python this who validation cat that test cat who that validation test
this validation test who that words who this validation validation this use validation who test	this validation test who that words who this validation validation this use validation who test
python this cat that words validation test python words that who python use this who	python this cat that words validation test python words that who python use this who
validation use words use cat this that training cat this words python training words use	validation use words use cat this that training cat this words python training words use
python use validation python cat cat validation cat use this that validation use test training	python use validation python cat cat validation cat use this that validation use test training
python cat use use cat this who python who training cat validation validation python python	python cat use use cat this who python who training cat validation validation python python
that validation this python training use use who test cat use use python use training	that validation this python training use use who test cat use use python use training
test use this validation training python cat validation this validation test test this test use	test use this validation training python cat validation this validation test test this test use
words training cat validation use that words cat that that that that cat cat validation	words training cat validation use that words cat that that that that cat cat validation
use test training python test cat cat training training cat validation this who that this	use test training python test cat cat training training cat validation this who that this
this that this training validation this words who validation cat this this validation validation this	this that this training validation this words who validation cat this this validation validation this
this training validation validation who test cat validation who who words that use cat cat	this training validation validation who test cat validation who who words that use cat cat
validation who cat cat cat cat validation this cat that cat validation that use who	validation who cat cat cat cat validation this cat that cat validation that use who
python python training python this that words cat who use validation use this who test	python python training python this that words cat who use validation use this who test
python test this python words python cat that this words cat test cat python words	python test this python words python cat that this words cat test cat python words
validation that this python who training validation cat who cat who training who words cat	validation that this python who training validation cat who cat who training who words cat
python python that cat python cat cat this use cat words test training cat this	python python that cat python cat cat this use cat words test training cat this
who cat cat training validation this that cat training python that that use test training	who cat cat training validation this that cat training python that that use test training
training who this words cat words training training words that validation validation training python words	training who this words cat words training training words that validation validation training python words
cat this use this who cat cat use cat words test validation test training who	cat this use this who cat cat use cat words test validation test training who
python who python cat training use cat who this words cat python cat use training	python who python cat training use cat who this words cat python cat use training
use test use test this training use python test that cat cat test cat python	use test use test this training use python test that cat cat test cat python
cat this cat this this validation test validation python python python words test cat this	cat this cat this this validation test validation python python python words test cat this
that test test use cat validation cat cat validation training python use test words cat	that test test use cat validation cat cat validation training python use test words cat
that validation validation training test python cat validation use test that use this this words	that validation validation training test python cat validation use test that use this this words
python python that cat who who words words python training cat validation cat test this	python python that cat who who words words python training cat validation cat test this
that that words that this that cat words python python python who cat who training	that that words that this that cat words python python python who cat who training
validation cat test cat use this training words this words python test use words cat	validation cat test cat use this training words this words python test use words cat
that validation training cat that use training use training training words test cat this words	that validation training cat that use training use training training words test cat this words
cat use python cat cat use cat validation who validation test who this cat cat	cat use python cat cat use cat validation who validation test who this cat cat
training training training cat that use use cat python python training training words cat python	training training training cat that use use cat python python training training words cat python
training validation use use cat cat who cat words test validation training use that who	training validation use use cat cat who cat words test validation training use that who
cat python words this this use cat that this cat python cat training cat python	cat python words this this use cat that this cat python cat training cat python
who cat cat python words test cat python that use that words cat this cat	who cat cat python words test cat python that use that words cat this cat
words words training who use training cat cat cat who that this python who use	words words training who use training cat cat cat who that this python who use
who use validation python training this who cat who words who test validation this training	who use validation python training this who cat who words who test validation this training
python use cat test that validation words this validation cat words who use this this	python use cat test that validation words this validation cat words who use this this
training words that words this python test cat that validation test test that words cat	training words that words this python test cat that validation test test that words cat
use that validation validation test cat test that training cat training that validation cat training	use that validation validation test cat test that training cat training that validation cat training
cat who this this python words this words who python python that use training cat	cat who this this python words this words who python python that use training cat
cat words words cat that words cat cat cat who that this words python who	cat words words cat that words cat cat cat who that this words python who
this who python cat this words training that training use that validation this cat words	this who python cat this words training that training use that validation this cat words
python cat words training test test words python training who words cat that use words	python cat words training test test words python training who words cat that use words
cat python validation cat this this words python validation test who cat python cat test	cat python validation cat this this words python validation test who cat python cat test
that training that training words use test words cat validation python cat python this test	that training that training words use test words cat validation python cat python this test
cat training python test test that cat cat validation validation who validation cat who python	cat training python test test that cat cat validation validation who validation cat who python
use validation words this training cat python this python python training training cat cat cat	use validation words this training cat python this python python training training cat cat cat
cat this this this python training this use training validation use use python training validation	cat this this this python training this use training validation use use python training validation
this cat use who who who training validation that cat who use python this use	this cat use who who who training validation that cat who use python this use
cat that this python who use words cat cat words this cat words python python	cat that this python who use words cat cat words this cat words python python
test cat validation training who that this training training cat validation who that validation test	test cat validation training who that this training training cat validation who that validation test
this cat cat cat python that use words cat test validation use training python who	this cat cat cat python that use words cat test validation use training python who
who who cat cat this cat words training training test who who validation validation training	who who cat cat this cat words training training test who who validation validation training
python words python this cat cat this who validation cat who python validation python this	python words python this cat cat this who validation cat who python validation python this
use python python training this training test validation cat test validation this words use cat	use python python training this training test validation cat test validation this words use cat
python words training who words training who this this test training that cat use use	python words training who words training who this this test training that cat use use
test words cat cat who cat this use training python who validation words test cat	test words cat cat who cat this use training python who validation words test cat
cat cat validation who cat cat python training cat training training cat that who that	cat cat validation who cat cat python training cat training training cat that who that
who who training validation words python cat words words who this this training python cat	who who training validation words python cat words words who this this training python cat
this python use who this validation training use who training test this training test that	this python use who this validation training use who training test this training test that
validation this words this test validation who cat words that python python test test python	validation this words this test validation who cat words that python python test test python
who cat who who python test this use training use test python training this test	who cat who who python test this use training use test python training this test
python python validation that training test that words cat cat training use training test use	python python validation that training test that words cat cat training use training test use
who python that words who test who test cat test who that words test training	who python that words who test who test cat test who that words test training
that that cat this cat test that use words that training cat validation python this	that that cat this cat test that use words that training cat validation python this
validation validation cat use who cat cat this training training who cat training use cat	validation validation cat use who cat cat this training training who cat training use cat
who training python cat test that words training who python who training validation use use	who training python cat test that words training who python who training validation use use
cat cat that who python cat that cat test python words use who python python	cat cat that who python cat that cat test python words use who python python
this use that that words cat python training use words this cat python training use	this use that that words cat python training use words this cat python training use
validation validation test training python use cat words who words that python training use use	validation validation test training python use cat words who words that python training use use
this python words who words test validation python test this this validation training words training	this python words who words test validation python test this this validation training words training
training that that training python cat cat who python use this test validation python python	training that that training python cat cat who python use this test validation python python
training test who cat this that training cat training python that cat test cat use	training test who cat this that training cat training python that cat test cat use
words who python cat that who words use that validation cat test training this cat	words who python cat that who words use that validation cat test training this cat
use use that python test who training cat that training cat use words words who	use use that python test who training cat that training cat use words words who
this cat words who cat validation words that use training training use cat cat training	this cat words who cat validation words that use training training use cat cat training
cat python use cat who who use that cat test test this that this cat	cat python use cat who who use that cat test test this that this cat
test who that training who who this cat training test python cat cat validation python	test who that training who who this cat training test python cat cat validation python
training use test cat words training training cat validation use use this use test this	training use test cat words training training cat validation use use this use test this
python validation python words training words python cat this cat this who validation who cat	python validation python words training words python cat this cat this who validation who cat
validation use this words training cat test this cat words words python this that python	validation use this words training cat test this cat words words python this that python
python words cat test test test test this words python validation test that validation words	python words cat test test test test this words python validation test that validation words
training test cat that this words python python test who cat python cat words test	training test cat that this words python python test who cat python cat words test
words validation validation who cat who training validation training cat cat python cat training test	words validation validation who cat who training validation training cat cat python cat training test
who that validation test test who words cat this cat training validation this who training	who that validation test test who words cat this cat training validation this who training
words python validation use that python who words training validation test training cat cat who	words python validation use that python who words training validation test training cat cat who
test test use training words cat python who cat this cat words words this that	test test use training words cat python who cat this cat words words this that
cat cat use use cat who validation validation test that cat test that validation use	cat cat use use cat who validation validation test that cat test that validation use
words words who cat python use words training that that cat validation training training this	words words who cat python use words training that that cat validation training training this
python use cat cat test who this cat python validation cat cat who this validation	python use cat cat test who this cat python validation cat cat who this validation
words python training who who training cat cat cat words this validation training cat words	words python training who who training cat cat cat words this validation training cat words
use training this who test who who test this use test this validation cat test	use training this who test who who test this use test this validation cat test
words test test test training who who cat validation test validation this validation training validation	words test test test training who who cat validation test validation this validation training validation
validation that words use validation who this cat validation that python training that that who	validation that words use validation who this cat validation that python training that that who
training python training cat cat python validation test words this test python training training training	training python training cat cat python validation test words this test python training training training
words python cat test cat who use cat who test words python who cat words	words python cat test cat who use cat who test words python who cat words
cat validation that python that cat this this use validation test training training validation validation	cat validation that python that cat this this use validation test training training validation validation
use cat words use words who training python training use this that cat that words	use cat words use words who training python training use this that cat that words
who validation validation who test this training test python cat validation this who training use	who validation validation who test this training test python cat validation this who training use
use validation use who who that training use who who who that cat cat who	use validation use who who that training use who who who that cat cat who
use validation words cat validation python cat cat words this cat validation cat words that	use validation words cat validation python cat cat words this cat validation cat words that
validation validation training cat test python test this training cat python who cat use words	validation validation training cat test python test this training cat python who cat use words
cat this words validation test that use cat use words who that words this validation	cat this words validation test that use cat use words who that words this validation
who training test use use that that training cat training who training this that python	who training test use use that that training cat training who training this that python
words training words test validation that python who validation this use python python use training	words training words test validation that python who validation this use python python use training
cat use this this validation words this python who that words python test validation who	cat use this this validation words this python who that words python test validation who
who who who that that cat cat this who words python words use who cat	who who who that that cat cat this who words python words use who cat
that cat validation training that that test validation test use validation test who test words	that cat validation training that that test validation test use validation test who test words
training who that this who words this training cat that who validation validation cat who	training who that this who words this training cat that who validation validation cat who
python validation that python use use validation validation use cat that python words use this	python validation that python use use validation validation use cat that python words use this
validation words python use cat cat cat cat cat words that training that cat training	validation words python use cat cat cat cat cat words that training that cat training
test python words words python cat words who test test test who test test cat	test python words words python cat words who test test test who test test cat
python python test python this cat words cat words this cat test test that who	python python test python this cat words cat words this cat test test that who
that use training who words training test use test that cat use training test this	that use training who words training test use test that cat use training test this
training use words validation that words python words cat validation cat training python that validation	training use words validation that words python words cat validation cat training python that validation
python python who python words test test who words who that test validation python that	python python who python words test test who words who that test validation python that
this words cat python cat cat cat use training training who words cat training python	this words cat python cat cat cat use training training who words cat training python
that use test use validation who cat this that use that test training who training	that use test use validation who cat this that use that test training who training
this use cat this who test training python words who validation cat use that training	this use cat this who test training python words who validation cat use that training
who training cat use who words use who training validation this use that use training	who training cat use who words use who training validation this use that use training
python use that who cat python use words use words test use validation who that	python use that who cat python use words use words test use validation who that
test use cat validation who words test validation use validation who cat training training validation	test use cat validation who words test validation use validation who cat training training validation
validation python this training test who this that test use cat cat cat training test	validation python this training test who this that test use cat cat cat training test
that cat words use cat that training cat python test test this validation python python	that cat words use cat that training cat python test test this validation python python
training this use that this that who use words cat words that this this use	training this use that this that who use words cat words that this this use
that that words test cat use python cat that who use cat test cat python	that that words test cat use python cat that who use cat test cat python
python cat this cat test cat cat python cat use test cat use who who	python cat this cat test cat cat python cat use test cat use who who
validation test that this this validation words test this that use words words test use	validation test that this this validation words test this that use words words test use
use training cat cat that validation test test words validation that cat this who use	use training cat cat that validation test test words validation that cat this who use
cat use validation test use test words use training python words test this training cat	cat use validation test use test words use training python words test this training cat
who training words use cat use use test cat words use words test validation training	who training words use cat use use test cat words use words test validation training
use use training python words that python who cat python cat test cat training use	use use training python words that python who cat python cat test cat training use
cat cat use use validation this cat who this words this that use words cat	cat cat use use validation this cat who this words this that use words cat
words python this cat that words test validation cat training that training use python use	words python this cat that words test validation cat training that training use python use
use cat cat words validation python that who validation python test this cat validation use	use cat cat words validation python that who validation python test this cat validation use
test this validation validation python python use python validation validation use validation who cat python	test this validation validation python python use python validation validation use validation who cat python
this that training python cat training test test use cat that validation this test words	this that training python cat training test test use cat that validation this test words
use use who cat cat test words use validation this cat that cat test use	use use who cat cat test words use validation this cat that cat test use
cat this who this who training python validation validation validation that python training use who	cat this who this who training python validation validation validation that python training use who
test python who python cat cat cat who python words cat words who training validation	test python who python cat cat cat who python words cat words who training validation
training cat cat training training who who validation use test use who who who that	training cat cat training training who who validation use test use who who who that
this cat this validation test use training this python who use that words training who	this cat this validation test use training this python who use that words training who
who python test cat words who cat validation python training training validation training validation training	who python test cat words who cat validation python training training validation training validation training
this cat cat words cat that words this validation use test use python cat cat	this cat cat words cat that words this validation use test use python cat cat
cat test python that validation words cat who cat test that who python test use	cat test python that validation words cat who cat test that who python test use
who who who validation training validation cat cat words who use cat words this python	who who who validation training validation cat cat words who use cat words this python
cat that cat python that this who test validation python use test that words python	cat that cat python that this who test validation python use test that words python
words who cat test training python python use words cat words validation words that python	words who cat test training python python use words cat words validation words that python
training that python test that python use training test python cat validation python cat words	training that python test that python use training test python cat validation python cat words
words this training that validation who that use cat that validation cat cat this python	words this training that validation who that use cat that validation cat cat this python
this cat that test who python training cat training test cat words that python this	this cat that test who python training cat training test cat words that python this
test words who use who this cat that this words python test validation words cat	test words who use who this cat that this words python test validation words cat
python python python validation cat cat cat python cat use python words cat python validation	python python python validation cat cat cat python cat use python words cat python validation
this use cat cat that who validation who training words python validation cat validation this	this use cat cat that who validation who training words python validation cat validation this
this cat cat test who cat this python use training test cat who who that	this cat cat test who cat this python use training test cat who who that
cat cat validation cat cat python python cat test cat training training use use who	cat cat validation cat cat python python cat test cat training training use use who
words who cat who cat use training who cat python cat this that who test	words who cat who cat use training who cat python cat this that who test
cat words words python training cat validation words training cat that this words cat cat	cat words words python training cat validation words training cat that this words cat cat
words use who test this this python that test that validation who this words words	words use who test this this python that test that validation who this words words
who cat who cat training python python training use cat that use that use validation	who cat who cat training python python training use cat that use that use validation
training cat who who use training training test python training python cat cat cat cat	training cat who who use training training test python training python cat cat cat cat
validation validation that cat that cat cat who use that training cat training cat this	validation validation that cat that cat cat who use that training cat training cat this
who that validation words cat who python who words words validation python this use use	who that validation words cat who python who words words validation python this use use
cat words training who python who training who words python use python that training who	cat words training who python who training who words python use python that training who
training training cat that cat use this training that cat cat who words test cat	training training cat that cat use this training that cat cat who words test cat
test use words test this cat who validation training that python cat cat who python	test use words test this cat who validation training that python cat cat who python
validation this this training cat this who that that that that test test test cat	validation this this training cat this who that that that that test test test cat
cat that cat cat cat use words test test python cat validation cat who use	cat that cat cat cat use words test test python cat validation cat who use
training cat who training python who use use words python who use cat training cat	training cat who training python who use use words python who use cat training cat
cat cat cat cat validation cat validation training who validation cat this that python training	cat cat cat cat validation cat validation training who validation cat this that python training
words cat test python cat test test test words use this that words words use	words cat test python cat test test test words use this that words words use
cat words that that cat training cat this cat test validation this python that use	cat words that that cat training cat this cat test validation this python that use
test cat test cat this who cat cat cat that who validation this cat cat	test cat test cat this who cat cat cat that who validation this cat cat
training who who training cat cat use cat test test test training who who training	training who who training cat cat use cat test test test training who who training
validation training training this training python use this who validation training cat this this cat	validation training training this training python use this who validation training cat this this cat
cat words python who this cat use training this validation that use use that this	cat words python who this cat use training this validation that use use that this
words test cat cat cat who that use training this validation that use training test	words test cat cat cat who that use training this validation that use training test
cat test who who python this cat this training this test cat cat cat python	cat test who who python this cat this training this test cat cat cat python
validation validation test test cat this test cat that who use who python this cat	validation validation test test cat this test cat that who use who python this cat
training cat who this training who use cat test that cat test that cat training	training cat who this training who use cat test that cat test that cat training
validation validation python cat words training validation words python cat python validation this that this	validation validation python cat words training validation words python cat python validation this that this
python words test training that use words training cat cat this training words cat training	python words test training that use words training cat cat this training words cat training
cat python who validation words words words use validation words test python this who who	cat python who validation words words words use validation words test python this who who
that words test who that python cat cat test cat training training training python test	that words test who that python cat cat test cat training training training python test
use this who words cat cat who words that cat cat validation use cat who	use this who words cat cat who words that cat cat validation use cat who
words validation this words words words training words test words training validation cat that words	words validation this words words words training words test words training validation cat that words
who test python that python python cat that words training this who this test test	who test python that python python cat that words training this who this test test
this words that test use use who validation who cat validation words words cat python	this words that test use use who validation who cat validation words words cat python
cat python validation this this cat that this words cat python who that use use	cat python validation this this cat that this words cat python who that use use
test use that use words that python cat cat validation this that validation cat use	test use that use words that python cat cat validation this that validation cat use
cat test cat test words test training python words cat words that cat validation cat	cat test cat test words test training python words cat words that cat validation cat
python use validation that that python that who words test that validation training that test	python use validation that that python that who words test that validation training that test
who python that validation this words this training this words python training python python use	who python that validation this words this training this words python training python python use
this words training that training words cat that python that who words test this use	this words training that training words cat that python that who words test this use
test who training use this test training training that test training python this python training	test who training use this test training training that test training python this python training
python this training training test cat test validation validation cat python this cat this cat	python this training training test cat test validation validation cat python this cat this cat
cat cat that validation this python use validation use test who words words test this	cat cat that validation this python use validation use test who words words test this
training validation this validation training this python cat python test use who this that use	training validation this validation training this python cat python test use who this that use
python use cat training this cat use who that who who words who this who	python use cat training this cat use who that who who words who this who
cat test test that that training cat test test test training who python cat use	cat test test that that training cat test test test training who python cat use
this that that that who use validation test validation cat cat who python training cat	this that that that who use validation test validation cat cat who python training cat
who test training cat python cat use this who that use training who training words	who test training cat python cat use this who that use training who training words
validation use use this use cat cat validation training training cat python test cat this	validation use use this use cat cat validation training training cat python test cat this
python cat who test test cat validation cat who validation words training words use test	python cat who test test cat validation cat who validation words training words use test
use words python python cat training python words this training who cat this training validation	use words python python cat training python words this training who cat this training validation
python who cat cat test python test cat that validation validation that validation cat that	python who cat cat test python test cat that validation validation that validation cat that
test validation cat cat validation that words who this validation validation use who that use	test validation cat cat validation that words who this validation validation use who that use
validation validation who that that python training cat words python cat training words that that	validation validation who that that python training cat words python cat training words that that
words training test cat that python test python words cat test test words validation training	words training test cat that python test python words cat test test words validation training
this training training training validation python that training use who that validation who validation python	this training training training validation python that training use who that validation who validation python
validation python test this cat validation validation who this test python this words training this	validation python test this cat validation validation who this test python this words training this
cat words cat cat training words this cat training that test validation training python training	cat words cat cat training words this cat training that test validation training python training
that validation use python validation words cat use this training python who test validation test	that validation use python validation words cat use this training python who test validation test
cat validation that cat cat who training cat who cat use that that that this	cat validation that cat cat who training cat who cat use that that that this
cat validation words who python that this validation training validation that who test validation test	cat validation words who python that this validation training validation that who test validation test
this words test words cat that test use test test cat words cat use test	this words test words cat that test use test test cat words cat use test
use that who python this that training who python python who cat cat validation cat	use that who python this that training who python python who cat cat validation cat
that who training use python who cat validation cat training training use this use test	that who training use python who cat validation cat training training use this use test
test words words words training who use cat training python words test python cat words	test words words words training who use cat training python words test python cat words
who this cat test use cat words training python test that validation python validation python	who this cat test use cat words training python test that validation python validation python
validation test cat who who test cat use training cat cat python who test that	validation test cat who who test cat use training cat cat python who test that
cat training use that test that that words use words who words this validation cat	cat training use that test that that words use words who words this validation cat
who this who who this cat who python this this use use cat python test	who this who who this cat who python this this use use cat python test
cat cat validation training use use that cat training cat test cat cat that who	cat cat validation training use use that cat training cat test cat cat that who
training this python validation this this test who training use cat cat cat that that	training this python validation this this test who training use cat cat cat that that
words test who use cat that cat cat who use cat who cat who cat	words test who use cat that cat cat who use cat who cat who cat
training that test who this this words cat cat words who use use test who	training that test who this this words cat cat words who use use test who
cat cat that who who that cat that validation who python this words training validation	cat cat that who who that cat that validation who python this words training validation
cat validation cat cat who test validation who this use validation words this who who	cat validation cat cat who test validation who this use validation words this who who
python words python training test training validation who cat python cat this validation use cat	python words python training test training validation who cat python cat this validation use cat
who words cat that cat words python cat cat cat python cat use cat training	who words cat that cat words python cat cat cat python cat use cat training
words that use cat python cat this python training cat this use this cat who	words that use cat python cat this python training cat this use this cat who
python validation this validation this cat that this python who cat test training test words	python validation this validation this cat that this python who cat test training test words
cat who cat cat test validation test python test cat that this that validation cat	cat who cat cat test validation test python test cat that this that validation cat
cat training that training training cat words test cat training who use this who test	cat training that training training cat words test cat training who use this who test
words use words validation cat this test cat test training this python words who python	words use words validation cat this test cat test training this python words who python
who use python who who test words test training that python test training words this	who use python who who test words test training that python test training words this
that python python training python who python test cat cat cat that python cat cat	that python python training python who python test cat cat cat that python cat cat
this cat that python that cat training cat use that python who this words that	this cat that python that cat training cat use that python who this words that
validation who cat test who cat words cat test python cat who who validation training	validation who cat test who cat words cat test python cat who who validation training
this validation test use cat python python that use that who python use python use	this validation test use cat python python that use that who python use python use
this that test training this that cat that use cat training validation training who cat	this that test training this that cat that use cat training validation training who cat
that cat validation cat use this cat who that test training python use training test	that cat validation cat use this cat who that test training python use training test
validation validation cat that use who python who use who validation cat that cat that	validation validation cat that use who python who use who validation cat that cat that
python cat test that words use this words cat who this that cat that training	python cat test that words use this words cat who this that cat that training
that use test words cat training use training words words cat cat python who cat	that use test words cat training use training words words cat cat python who cat
use test test that who use use who this test cat words python python test	use test test that who use use who this test cat words python python test
who cat python use this that validation who validation that python training python cat validation	who cat python use this that validation who validation that python training python cat validation
python who validation python cat python words this that cat use use training that validation	python who validation python cat python words this that cat use use training that validation
training validation words this validation cat cat training that who this use words that who	training validation words this validation cat cat training that who this use words that who
validation use validation validation cat cat training test python validation use words use words training	validation use validation validation cat cat training test python validation use words use words training
this use cat cat cat cat validation python test this that cat who python use	this use cat cat cat cat validation python test this that cat who python use
this training cat use python this training validation cat test validation that training training training	this training cat use python this training validation cat test validation that training training training
test words training that python words that training validation that this cat use validation who	test words training that python words that training validation that this cat use validation who
words cat cat that words use this cat use cat words test training this who	words cat cat that words use this cat use cat words test training this who
this use use python words validation cat use validation this validation words cat that python	this use use python words validation cat use validation this validation words cat that python
who who use training cat use who cat this cat training that cat validation cat	who who use training cat use who cat this cat training that cat validation cat
cat that python use that test python test cat cat test use cat who training	cat that python use that test python test cat cat test use cat who training
words validation who validation that who cat cat use training who cat words that training	words validation who validation that who cat cat use training who cat words that training
who cat that cat cat validation python cat who who test this validation words words	who cat that cat cat validation python cat who who test this validation words words
python words python that cat cat training training words words python words words validation cat	python words python that cat cat training training words words python words words validation cat
this that this this that cat validation that that validation words test test test words	this that this this that cat validation that that validation words test test test words
this test validation that test that words python this python that who words use python	this test validation that test that words python this python that who words use python
cat training who python test words python python this python python validation words cat test	cat training who python test words python python this python python validation words cat test
use that this test cat that this cat cat training use this who that training	use that this test cat that this cat cat training use this who that training
cat cat training this cat who python validation validation that use cat use test words	cat cat training this cat who python validation validation that use cat use test words
words use this training training cat validation validation that this python this validation validation cat	words use this training training cat validation validation that this python this validation validation cat
cat cat words validation validation test validation test that who training python test use cat	cat cat words validation validation test validation test that who training python test use cat
who that cat validation this training this validation who words words python cat cat cat	who that cat validation this training this validation who words words python cat cat cat
use cat training who cat cat this who validation training test training cat who use	use cat training who cat cat this who validation training test training cat who use
cat training training this test who validation that use words test cat validation cat that	cat training training this test who validation that use words test cat validation cat that
cat that this cat words python test python cat who validation cat validation training use	cat that this cat words python test python cat who validation cat validation training use
validation who cat words who words use this who words use this python cat test	validation who cat words who words use this who words use this python cat test
this that cat use training validation validation cat test this use who training cat cat	this that cat use training validation validation cat test this use who training cat cat
cat validation cat cat words test cat cat cat that that that words cat use	cat validation cat cat words test cat cat cat that that that words cat use
cat use cat training cat this who use validation that validation words use use use	cat use cat training cat this who use validation that validation words use use use
validation training cat words training use test use who use validation validation use cat use	validation training cat words training use test use who use validation validation use cat use
cat words that this validation training training test test training words test training use that	cat words that this validation training training test test training words test training use that
use python test that that validation who that who words use cat use words use	use python test that that validation who that who words use cat use words use
python test that python cat use test test who cat use words cat test cat	python test that python cat use test test who cat use words cat test cat
cat training validation that who cat that words words cat validation use validation validation cat	cat training validation that who cat that words words cat validation use validation validation cat
training training cat cat words training training that this that use this training training cat	training training cat cat words training training that this that use this training training cat
cat words words python cat who training validation words training training validation this words python	cat words words python cat who training validation words training training validation this words python
training validation training python python this validation this validation who cat words training validation who	training validation training python python this validation this validation who cat words training validation who
this test use cat who python cat that test training validation who cat cat who	this test use cat who python cat that test training validation who cat cat who
training cat words who who who words cat who training test who validation training who	training cat words who who who words cat who training test who validation training who
training test cat words who who cat validation this validation test training cat training that	training test cat words who who cat validation this validation test training cat training that
python validation that python who validation use cat cat who cat that cat that training	python validation that python who validation use cat cat who cat that cat that training
this who this words test validation use this test test words who words cat python	this who this words test validation use this test test words who words cat python
who training cat validation use that python training python that cat that cat that test	who training cat validation use that python training python that cat that cat that test
test validation python python cat python who cat test who that who test validation python	test validation python python cat python who cat test who that who test validation python
this words cat use training python validation validation cat use validation that test words use	this words cat use training python validation validation cat use validation that test words use
that test who cat use training words that who python cat validation that this words	that test who cat use training words that who python cat validation that this words
python cat cat use cat use cat that cat training validation this validation this python	python cat cat use cat use cat that cat training validation this validation this python
words python this validation cat who validation use validation cat validation training validation that validation	words python this validation cat who validation use validation cat validation training validation that validation
test cat cat python python validation validation that this who that this that test words	test cat cat python python validation validation that this who that this that test words
use test training who that words cat that this words python this python use this	use test training who that words cat that this words python this python use this
this who training words this that this use words that test test this validation test	this who training words this that this use words that test test this validation test
validation that that validation validation cat use use training test test cat training this training	validation that that validation validation cat use use training test test cat training this training
that use words cat training training words use training cat use validation words python python	that use words cat training training words use training cat use validation words python python
cat that cat python training training validation words use that that python validation cat test	cat that cat python training training validation words use that that python validation cat test
cat that words training test use cat test validation training validation python words who training	cat that words training test use cat test validation training validation python words who training
cat cat this this validation validation training validation who words training training that this who	cat cat this this validation validation training validation who words training training that this who
cat training validation test that test words cat use that training validation cat that test	cat training validation test that test words cat use that training validation cat that test
validation use test who validation that python training training cat test validation use cat test	validation use test who validation that python training training cat test validation use cat test
cat words who cat this who use validation cat use cat cat test validation python	cat words who cat this who use validation cat use cat cat test validation python
this who that words validation that who cat use use cat training training python validation	this who that words validation that who cat use use cat training training python validation
cat validation test test training that cat python use who who training validation use test	cat validation test test training that cat python use who who training validation use test
training validation training training that training cat test use cat that words words cat test	training validation training training that training cat test use cat that words words cat test
cat training words cat python that python python words words test that test test words	cat training words cat python that python python words words test that test test words
this that cat training this python python validation who cat words python python words that	this that cat training this python python validation who cat words python python words that
this cat cat cat this that cat who use test words words validation python who	this cat cat cat this that cat who use test words words validation python who
test use cat this test test python that this use cat cat validation test validation	test use cat this test test python that this use cat cat validation test validation
cat this use use use validation use python use that test training that this that	cat this use use use validation use python use that test training that this that
cat python training training validation cat words use this validation words training test cat this	cat python training training validation cat words use this validation words training test cat this
use test words cat python validation use who validation cat this python use words cat	use test words cat python validation use who validation cat this python use words cat
use who cat this validation words validation validation who training training training validation python python	use who cat this validation words validation validation who training training training validation python python
that validation words training this python cat who who that cat this test cat test	that validation words training this python cat who who that cat this test cat test
words words training python who training words validation use cat cat cat cat cat test	words words training python who training words validation use cat cat cat cat cat test
cat test words this cat use cat words use use python test use who this	cat test words this cat use cat words use use python test use who this
cat who training training python cat cat test test cat cat training test test cat	cat who training training python cat cat test test cat cat training test test cat
this who cat this cat who that words who use python who words test words	this who cat this cat who that words who use python who words test words
that this validation validation who python cat training that python cat who training who cat	that this validation validation who python cat training that python cat who training who cat
training training words use use python training validation this test that python who cat use	training training words use use python training validation this test that python who cat use
who cat cat use this validation training this cat cat who words test python words	who cat cat use this validation training this cat cat who words test python words
that that that use test python validation this use python this cat validation test test	that that that use test python validation this use python this cat validation test test
cat cat this validation validation this this cat that validation cat test training who test	cat cat this validation validation this this cat that validation cat test training who test
this use this cat test cat training cat python cat use training words cat use	this use this cat test cat training cat python cat use training words cat use
cat training test words cat validation cat cat that that python python this python cat	cat training test words cat validation cat cat that that python python this python cat
this that who this use validation who validation that cat python cat who cat who	this that who this use validation who validation that cat python cat who cat who
cat test python training use this this that cat this validation that this that cat	cat test python training use this this that cat this validation that this that cat
cat cat python who this python python this training validation use training this who cat	cat cat python who this python python this training validation use training this who cat
words cat that python python that that test that python validation training training words test	words cat that python python that that test that python validation training training words test
python that cat that who use that words this use this python cat that who	python that cat that who use that words this use this python cat that who
words cat that that use test validation cat cat test who words validation that training	words cat that that use test validation cat cat test who words validation that training
python that that that cat this training that who test that this cat that words	python that that that cat this training that who test that this cat that words
test who training that cat training cat validation words that python python test validation training	test who training that cat training cat validation words that python python test validation training
use python that who that training who who who that that python python cat test	use python that who that training who who who that that python python cat test
python words test words validation use test python use words training cat training test validation	python words test words validation use test python use words training cat training test validation
words this who test words that validation that use python cat who that python use	words this who test words that validation that use python cat who that python use
words validation training use words that words cat cat training this that validation words that	words validation training use words that words cat cat training this that validation words that
cat validation who cat this words training use training this words training words test cat	cat validation who cat this words training use training this words training words test cat
this validation cat test training that use training cat use who words use words cat	this validation cat test training that use training cat use who words use words cat
cat words python test test training cat words training cat cat python test that who	cat words python test test training cat words training cat cat python test that who
test that words test use cat training this cat use cat this test test that	test that words test use cat training this cat use cat this test test that
validation that test python this cat validation cat python this validation test python validation python	validation that test python this cat validation cat python this validation test python validation python
words that test validation that test cat training python that words that words validation this	words that test validation that test cat training python that words that words validation this
use python cat that python words validation that test this that this cat use test	use python cat that python words validation that test this that this cat use test
python test words use test who use cat test that words words words python cat	python test words use test who use cat test that words words words python cat
cat cat cat cat who test python use use training who training python validation cat	cat cat cat cat who test python use use training who training python validation cat
that words who use training training cat who validation this use cat test this who	that words who use training training cat who validation this use cat test this who
training this who words that this validation use words validation use cat who this python	training this who words that this validation use words validation use cat who this python
this words test cat who cat this that training python training training test test words	this words test cat who cat this that training python training training test test words
test who python validation that cat use use cat cat that cat python training training	test who python validation that cat use use cat cat that cat python training training
training this cat python test training python words use validation python python who that words	training this cat python test training python words use validation python python who that words
cat who training who cat that cat validation cat that validation training use who words	cat who training who cat that cat validation cat that validation training use who words
python test cat that training validation training use who that cat validation test words words	python test cat that training validation training use who that cat validation test words words
python use cat cat that test python use words that validation training cat cat validation	python use cat cat that test python use words that validation training cat cat validation
cat words cat words that python who cat validation words this cat training this validation	cat words cat words that python who cat validation words this cat training this validation
this python validation use validation this this cat words python cat validation use use this	this python validation use validation this this cat words python cat validation use use this
validation who test cat training this validation test words cat validation that that cat who	validation who test cat training this validation test words cat validation that that cat who
validation that cat cat cat words cat who training this cat cat python words that	validation that cat cat cat words cat who training this cat cat python words that
words words test this validation this cat that that validation this test words test cat	words words test this validation this cat that that validation this test words test cat
who this validation that that validation cat validation cat that cat test that that words	who this validation that that validation cat validation cat that cat test that that words
cat words cat words who this use use this words validation cat test python who	cat words cat words who this use use this words validation cat test python who
use this cat cat use cat training validation who cat who cat validation training use	use this cat cat use cat training validation who cat who cat validation training use
cat test python that test that cat cat that cat use training that python python	cat test python that test that cat cat that cat use training that python python
words cat this validation that validation cat cat training validation who cat use cat this	words cat this validation that validation cat cat training validation who cat use cat this
this cat cat python cat use training cat words that this use this test use	this cat cat python cat use training cat words that this use this test use
