cat cat cat words cat test test use cat use that words cat python test	test words training this test training cat use python cat
this cat use who test this test test training cat cat python this python validation	this cat use words python cat cat cat validation test
python use use cat cat that this cat validation words cat that cat validation python	use cat cat test cat test use python who who
python cat cat that cat that cat test this validation python test cat who training	words who who use python python cat cat cat that
validation cat use cat words use use training python words this python cat use use	this use use this words use who validation validation training
test that python use training python test words this use use validation cat python words	python validation who cat use validation cat that cat python
words use cat who validation who use that this words use cat words cat words	cat who cat cat this validation test cat cat test
validation python training who cat python who use training cat validation python who validation python	training training test this that cat test this training that
cat test this use words training training python words who this use cat that cat	this who use cat words cat training that this words
training words training this words training python that who python that cat python validation this	cat that python test validation validation this python who words
this cat who test that cat python cat cat this python python validation who test	training validation words validation test cat training this that training
cat who cat training test who use cat use use python test validation cat python	that python python test python test validation use validation cat
test who use words cat use python this who words who this test words who	cat use words words validation that that words words this
words python words training test validation who that validation cat validation this words that test	python validation test test cat python use test use this
that python words training training python who words that who cat this training test that	cat validation training python who use this words cat python
training cat validation this training use cat cat this training training python this words python	this this cat cat test test words this cat test
validation validation cat that training test training use cat test cat python words who validation	who cat use validation use use who that use words
who test python python cat use test words python words test training test validation use	that cat cat words that python training test python training
training cat use this words cat cat test that who this cat use test validation	words use training cat this who who cat use cat
that test use cat cat who who who that test test words cat training python	validation this cat python training who test python words validation
words cat this test use validation python this training validation use validation cat words that	cat use who training who cat validation test who validation
training use cat training words cat words validation cat who cat words python cat that	training cat cat validation training cat words test words test
who validation this validation cat cat that use who python validation training cat use this	words training training training who this python test use who
cat validation words training training who who this cat words that this cat python validation	use cat python use use python who training test test
validation test python that that training this use training that words this that cat use	words that use validation training test test training cat this
this cat cat this this who that cat this training cat cat validation validation this	this validation cat python test python python test this who
cat words training cat cat who this this words cat who validation validation words test	use training who this words training python that that python
test cat this cat cat that python cat that words who words who cat cat	use training who this python who words python cat training
who cat words training validation use python training who cat training that words use cat	this validation this words words cat who training this this
test cat who cat that cat cat validation who use python cat words test cat	that test cat that python python validation use validation this
this this cat training validation this that that training words cat that use words use	this python test that cat who words cat this test
use training validation who this training cat this cat training validation cat who use cat	cat python this cat who words validation use test training
this test python cat use use validation words test that this this cat python cat	use python cat that that test training validation cat this
that this that that this use cat python that this training who python use training	words training who who cat this this who use test
cat words words cat who cat words training who that python validation cat use that	that who validation use test validation python test that python
who test that cat this cat that cat python who python python that cat cat	validation words that use python training validation cat training test
validation that validation cat words cat that this validation this training cat who who python	python this that training python that test words validation who
cat python that validation that cat use use that this cat test training who this	that validation python that validation that this validation that use
training words this who words this use validation python validation python test validation validation this	cat this python python validation python words validation test this
words training that python python validation python validation python cat words use this training validation	that who who test python validation this python use cat
validation cat python cat python cat words who this words validation that test use words	test use use use validation python this words words training
validation training validation use words test that words this test who test validation cat this	python training training validation that use cat cat python validation
cat test cat who use words training use that use validation cat cat that words	test that who this cat cat that cat validation use
who cat cat words words cat training training validation validation cat words who test cat	this cat validation python cat validation training this cat cat
cat test cat training validation words this test who training use test cat that test	this test training cat training training cat test words who
words this words words validation test who validation this python training python cat that this	training validation validation cat validation test training who this validation
cat test cat python this who cat training this training python use test cat cat	cat cat this use validation cat training validation training cat
cat cat use training who words that python validation who words validation words test use	use cat training cat this use words cat training cat
training training words this validation words use words python training training validation cat training that	cat words who training this words use use training validation
use words this this words cat python validation this validation who that that training test	training that who this use that cat words who that
cat validation who cat who cat python that that python training that cat training training	training this this training cat words validation this cat that
test cat cat training words validation python words validation words who cat test cat that	who use words this training cat validation test who python
training who cat words validation training use that cat words use that validation that use	cat python who validation who test python training words validation
validation cat that validation cat python this this cat that this cat training training this	python cat test validation test that this who that validation
cat python cat this words validation training use who this cat words test cat training	python validation training this test training that cat that training
test who validation words test cat test python who validation this words cat python python	that who use use python this use test cat cat
validation cat training that cat use validation this this use that training who test use	cat validation validation python training validation cat words python who
this cat this words use who use test that validation words python who use that	cat cat training who who words this this this who
python test words validation training this cat words use cat this words that validation cat	test cat words python that cat validation this cat training
this use who validation test this cat python use test test that test that test	test cat this words that cat this cat words words
cat words cat cat that training validation cat words words validation this words training that	test this use cat use use that words training cat
words this cat python test cat words who cat words that training use test cat	cat cat words use test cat use cat that cat
validation use that test validation test cat that training validation validation python validation cat this	python that test test cat test words that cat use
this validation cat that that that this training test training test training training validation cat	validation this cat training that training validation test cat words
python this that validation words cat use validation who training use who use python cat	words cat cat training python that that who this cat
validation test use this cat that cat test that test python cat training who use	who training cat training this cat that training python python
this that test python python cat python words validation use who training who cat that	use test validation training cat python who that training python
training test training words validation cat training test cat cat that words python cat validation	training validation cat python validation training who that training cat
that training test cat use cat test test use who use validation python words test	python cat cat validation cat this that this who test
use this python use cat who python that cat use test python test python use	validation test words that training use python python test who
use training validation training cat who training python training that training that python cat python	use that who cat words cat who who this this
this python that this training test use training test this words cat who test this	test training use this python test who validation test validation
training validation cat validation cat words use cat who test test cat cat training python	cat who words validation python validation that that this this
that validation validation cat validation who test training that python that validation that that python	cat training test use cat validation cat python python test
cat words test this test cat words python test validation training python cat cat cat	cat cat that validation training who validation python python this
use cat python training this that this this validation this this test who this this	cat validation that use who test words cat cat use
training this who cat cat cat that use that validation python that python training this	validation words training cat training cat this test training python
use that this test test python who cat this words words test this training training	python test this words training training validation training test use
words that cat python that training validation use python words python validation use validation cat	validation this test who who words that training cat that
that use that this that training who python words words validation who cat that who	this use test python training use python training use validation
words validation words training cat cat words this this use who use words test use	who this test training who test test cat cat that
words that who python cat validation test that training python that cat test this this	that training use training training this cat use use python
python this test words cat use test cat cat words words use cat this that	words training cat who that cat words python cat validation
python who python who who this python words cat use use training test who validation	words training use who cat cat use cat python this
cat cat this test words words words that test use this who cat python that	training this validation cat cat that words cat validation training
who validation who python that training words use this who this use that use words	cat words cat training this cat cat training test who
cat who test training words who words that test python who cat that this words	this python validation cat words python python validation cat use
use python that that that validation training python this words this who use use that	that test training this test python cat cat python that
that test python training who test use training cat validation test test training cat that	test validation test use training that python that that who
validation cat cat this cat validation this who use cat who training cat that training	cat use cat test that who training training test python
words validation test use words use test use words words who use this python cat	cat words cat this validation cat validation that this who
who test that training use test that who validation use words validation training test who	test python words words use training this who python that
this test who use who python python who validation cat this that validation who that	this cat this validation that cat training words test training
cat python python cat validation validation training test cat training cat this python validation use	that this cat words training words words that this python
this this cat test this this validation python who this validation cat validation training this	that who who training validation training words python cat cat
words test validation this test who python use training training test this this python use	words test cat use use that test words training training
cat use python use python who python words cat that training this use words this	words training training words this training that cat cat words
cat use who training words use words validation this cat who use words this cat	who this test cat use that words validation training words
words words cat test cat training python cat python test validation test cat cat that	python python test words words that training cat validation use
cat training python training cat this use cat python python this who use cat words	that python validation training use test words validation cat use
training this training test validation validation use test that validation training this python this cat	validation cat that cat python test who cat words cat
this that validation test test python cat who cat who who that this use python	that cat cat this cat training python words training cat
training training that use use training cat validation who python validation training words this python	training use python that validation training use this words test
training python cat who who cat use python cat validation who words validation that words	use that training who cat words training use use training
python words validation validation validation words words this test who this cat cat cat use	who this validation use use cat that words words cat
use who cat words training cat training cat test this this that python this test	training cat test who use who validation validation training validation
cat cat cat training validation python use python cat validation validation python cat python validation	cat use training this test who training training validation use
validation validation test training validation cat cat that validation that test validation cat use who	use cat python this cat words words this cat validation
validation this this that that training cat cat test validation words that cat training cat	this words cat who cat cat python cat words validation
use cat python who cat words who validation this words who this use that words	cat cat cat this that validation this words python words
cat that python validation use this cat validation validation who python cat who words cat	validation that validation that training this cat who validation python
that use words python that python this use cat use python python python python that	words cat test python cat that this cat python who
cat cat words use use test training cat use use this that words cat cat	validation validation that that that words test that validation use
cat that validation use cat test this use that python this python validation use use	training cat cat validation cat words test training that words
validation cat test validation use test words who python cat cat words test test cat	words cat validation cat who training this words training that
this cat training that use validation cat test test this validation python training training that	cat training test python words this that cat cat that
python cat cat that python cat that validation that that words test that who this	cat who use use training validation that that who who
who python that python that who use test this cat cat who training test python	who that test cat cat use python cat training this
this who use that who use use words words words cat cat that test use	test this words this validation test words python test test
words this this python use test validation that cat who training use words words who	use cat cat words test training use words training training
this python cat who use who test who cat who test python who who test	that test training cat cat who python this validation this
cat use cat that validation who cat cat this use words python test that validation	use python use cat use cat test that cat test
that who this python cat use that this words who cat cat validation training cat	training use use cat that words python words python python
python cat words python that test test use use who this cat cat training training	validation words words test cat words words words test use
who cat validation this python test that training cat test training words who test validation	this cat words test cat that that validation python python
use validation test python that who this who who who validation use words training that	use words this cat validation validation training python python words
test use validation cat cat test validation validation test who words use that cat that	that words test this cat cat training cat validation who
this validation words this words this cat test who training cat cat training cat python	validation cat cat cat use words validation use words use
test words training this cat cat training that python test who cat python cat this	test words that cat python validation test cat training cat
test this words this use use test python python who use use words training who	python validation validation this that that who cat cat who
who validation cat test cat use who python cat that training cat who cat words	validation words cat this words validation use cat this test
training test training python cat cat cat words python test who that python that validation	test words training validation validation cat cat training cat cat
words training python use that validation who use test validation cat use this training test	this who python who words python cat training cat words
cat python this who test cat training who use use words cat who cat that	test cat words cat python python cat python cat cat
who validation that use this validation test that that python words words this that test	test that python cat who use words this cat training
cat who python that training that cat test python python this this this validation training	test python training this this words this use training words
words words this words words words use validation use words words this validation cat use	this cat python this cat python this cat test who
words this cat who cat cat use use use use this use words cat validation	training cat cat this validation training that training validation words
who test that validation words cat training this that training who training use training cat	test this that this that that who use validation cat
python that this cat that use cat cat training this use test this training that	validation python validation test python test python use use this
validation words python training words use that test python test cat python who validation words	training this python cat cat python use validation words test
validation test cat that cat training cat words cat validation words cat validation this python	python training who who use training who this cat this
test validation training words words that python training validation cat who use test use cat	cat that cat cat cat cat training use training test
cat python test training test words python training python cat use cat training test test	this who words training who who cat test that cat
this test cat words validation that cat who this use words cat training python that	that cat who cat training use cat that cat use
words validation use python use who who test training training cat use test validation test	use training training use who words this test training that
words test cat this cat words training cat use cat who use cat cat validation	cat cat cat python cat cat validation training that words
who this who cat words python test training use cat validation cat training validation training	python use test use who who use this cat test
cat cat validation who that this cat cat use this who training cat cat validation	words training use this cat test cat test that who
that python cat this cat test who who who python that validation cat cat this	use this use that python this that training that cat
validation python that test cat that this who training test cat training python cat validation	test use python python test this validation python use python
cat python python training that this words python cat this validation cat words training test	cat that that cat who that cat use use test
python cat validation test cat that training who use cat training test this training who	words cat use validation use test who use this validation
training who who training cat use test words python validation cat use that validation python	validation cat that who cat words use use validation test
cat that this use that test words this words words cat cat cat that validation	that python words training cat that cat test who cat
words cat words training words python training that use that use that validation training who	who use this validation cat cat use validation use test
who test that validation this python that cat test test cat use cat cat python	this validation this test python that use cat python training
use this validation this training words cat use this validation cat test training that that	python this python use python words validation test validation cat
python test that python cat cat use use cat cat test test this validation cat	test this cat use test who use this cat use
use who test use cat python test that words validation who use python cat cat	cat cat cat python validation test cat words who words
use this use who cat validation training that test that that validation cat words use	test use validation this training training use who words validation
cat cat validation this cat cat words cat this this test validation use training cat	words cat this cat words test who cat that cat
use cat who python that who this training who words validation who use cat that	test python this python this python cat test test training
words cat this words python that cat words who use test validation this this who	training training python training validation training python validation use test
validation cat python test words cat who python training test use use training words cat	python who validation validation training who training words test training
test cat words test cat python who words training cat this cat words words words	use training cat python training validation python this use test
cat python cat test that who words this validation training this cat cat test this	cat test that training this use who validation this validation
test validation cat words python cat who use who cat training that that that this	cat training cat cat this python that who who python
words use cat training this cat cat that test words who validation cat words use	cat validation who words python cat words test words python
cat who cat cat training use words that cat cat words cat this who words	use training words test this cat training cat who cat
python validation validation words test validation use who cat that this words validation python that	test words validation this cat that words cat cat this
python cat cat that validation test use this words python who cat training that that	who who this training that training who that python words
who this training cat cat this test python that this python python this python this	python that cat cat cat that test cat cat that
that use cat this cat who who python that training who that python cat that	python cat training test test validation use validation this who
who python this cat this this that who test test that training use training validation	that this cat who that words this test validation words
who python training use words that validation use who use this validation training cat cat	this words that validation that use test this who test
cat cat cat that python validation words that cat python validation use that test training	that this validation this use python test validation words training
that cat cat python words test that this use cat who this validation test who	this this training validation use cat who that this use
use cat words use words words cat cat test training words validation test training training	python words cat words test use validation words that training
this training test use words cat words python use cat cat use cat who python	python this python who training python this words this validation
python cat words who words training that test who cat python training who words python	validation who that use use cat test who that cat
validation test validation training that use use this words cat validation python cat cat validation	this who this validation that who this who python python
words cat words this training this validation test who cat this that test cat who	words cat that this this cat test use training cat
test words use python python training who validation words python who validation that python validation	cat python test that python python that test validation who
test python this that who training words who validation cat cat validation words cat cat	words python this validation that cat test this cat cat
that training training words words cat training that validation cat validation python training training cat	this use that test who cat words that cat test
this training cat test that who who training who validation training training cat this cat	cat who python training python validation who who python that
that cat validation test that who this use words who training who python words training	words this validation who this who words cat this cat
python cat cat validation that use this python who cat that that that words use	words cat who cat training who cat cat that who
who python test who validation cat python training this test test cat training test validation	that words this test who cat python words cat training
this use who training test test that use who this cat cat that who cat	words cat validation words training test words words cat that
this use use test that validation training words training python cat who validation validation who	cat words that this who test this training test test
python test that cat test that cat words cat who who use this cat use	who that that test this training use cat this training
that test test cat cat that cat python test python that words cat use who	use test who training cat validation words python validation this
test test training cat test python who validation cat test test use who validation training	cat python test cat words use who who words training
validation python cat python who words cat python that this training who validation this who	cat validation cat that training validation words python cat validation
this cat cat test cat cat this training who words that python that cat python	this test this validation test that who validation validation test
validation who use python cat words this cat validation use who python this cat that	cat cat words that who this who validation that validation
cat words this this use this use python cat words this who cat validation who	cat cat who training cat training that who use test
words cat test validation cat who validation that training who this validation python cat training	test cat training who cat this cat test training who
cat training who cat use that cat cat use use validation this that use python	validation use who who python cat validation test python validation
this that cat words that test that python python words use python test validation test	that who training words use that python cat python cat
this cat words cat python words validation test cat cat python use training python cat	that validation cat python python cat training test use training
that cat use this python python validation cat who who python this this validation who	that that use words use words that this that cat
that use this that cat that that who training python words test validation this python	test use this cat use python words training who test
validation words use words validation cat validation this this test python that that that cat	validation cat training validation cat validation words use cat training
use use use test test who test cat cat python training python python test who	python cat use validation cat that that validation test test
training words cat that test python python test use test words that validation cat that	training who cat cat validation cat use cat python cat
training that this training who test python validation that python this this this use words	words validation use validation validation test words cat cat who
that cat cat test validation that python validation cat validation use training who validation training	training training test that validation this validation cat cat that
words cat validation python test training validation validation validation who use words cat training python	use words training use validation use test use cat cat
python validation that cat use python training training cat that test validation python cat that	this this cat words cat cat test who validation cat
who test test this cat this cat that that use cat cat this words use	test use training this test who python that cat validation
cat use this this validation cat words cat training test use this training use python	cat words python words validation cat use training that cat
this cat who this this test validation validation cat cat words training cat that this	this python cat validation validation cat python training this training
that who who use words training that who words that cat test cat that who	training words validation cat validation validation training words validation who
validation who cat cat training validation cat use words words training validation words cat use	validation words test that training test who cat words who
this this training cat that that that python cat python validation python test python this	cat python python python use use this training that this
python this validation validation test validation cat test training python this words test cat that	test cat who that who who cat validation use test
training who validation python training who cat that validation python who test test cat python	python python words words test validation python words this use
words cat use test validation training python use words cat who this who this cat	python cat cat training words cat words test words cat
validation who this python training validation that test test cat that use cat python that	cat that cat this cat that test who use validation
python words use this training use use use this who test who this words validation	validation use training who words cat training python this validation
validation test cat test test training cat cat that validation that test test use cat	words words words that validation cat that who cat training
that validation test this python this this cat validation this use python this that who	who cat who validation that cat who who validation who
training this words use that who that test who this use python words use cat	use validation use test python validation this training who that
cat cat use test training test that use who cat cat this use cat cat	python who training training who validation test cat this use
words who use training words cat this python words use words test who training cat	use python training cat validation cat that use this python
python cat validation cat this this test python use training cat training cat who validation	test training python test test test python validation cat python
use use test cat cat python this cat training test that cat training test validation	training who test test training test validation this that training
this python use words validation words this python cat test words use test validation python	cat test use cat training cat validation validation validation training
who cat python who training words this this who this training training cat validation cat	python validation cat use words that use that cat cat
cat cat training who this training test use who cat words test test python validation	who python python test use use test that test cat
test who cat use words that this use test this training use training who that	python test cat words validation who this training this who
python this use training validation this who validation python that use test test who words	training training words that cat training that training use who
that python python that python training that that this training cat this training test validation	this that python who cat cat validation cat python who
this training python validation words cat use words test cat who words training validation training	cat python cat who validation cat validation cat cat cat
this this training cat validation cat words words this who test cat cat cat validation	cat training cat this test this python cat that test
who validation words python cat cat test words this cat that cat cat words this	cat use cat who python words this cat that cat
words python use validation cat words this that cat words python use words training words	cat who validation validation this words python test test this
this words this test who use test that use cat cat validation cat words who	words training validation test that test python cat cat this
training python test use use this this test use python cat this use validation that	training use validation cat that this test cat cat training
validation that this python use training use cat cat test cat that words test words	words words use words training words that validation python who
that that words test who cat that words training who test test that validation python	cat who who training use who test test test this
cat who test test this words test python who validation python training python training this	validation cat cat this cat test that who use cat
who cat that this who this python this test this use training this that cat	who use cat cat that that this who use test
test words use words words words cat cat this cat cat use cat test cat	use this python validation words who this words who words
who that use cat cat test cat test python test test validation training training validation	training words use python training python cat python who cat
test use words training training this cat use words python test cat training validation use	who who that words that python that test python cat
this python python who training validation python python python training this test use that that	who validation validation test validation this cat python who who
training use words test use validation training who validation who words this use words validation	cat training cat test this that validation who python this
use this words test cat cat python training python test cat who that use this	use words python validation words this test test training use
that that use python words cat training that this use words test that cat this	that python python that who training words python test validation
cat cat python test who validation words use training this test test that cat test	training this words this python cat that words python use
training use test words cat training use use cat use use cat test use this	cat validation words words validation python validation cat who validation
validation test words use that training cat training cat validation cat test cat test python	python validation words that test training use this cat cat
this cat test use that that cat cat python validation cat cat who cat cat	cat python validation test that cat cat this cat test
cat validation words who who python cat words training validation this this python cat cat	that validation training training validation cat who words words that
who test words python training use who who this cat cat test training cat words	that cat that this that validation test cat cat this
validation who validation validation python test that test python that python validation use validation this	use cat test who cat this that test words cat
use cat this python use cat that python validation words training test words cat python	words training that that use words who python training this
validation python use use that words cat cat words python use python cat use who	test that words test cat cat test training this this
this use this cat this test this test cat training validation test cat validation use	this test who words use use test python use that
python use training who this python who words that test that cat cat cat words	this python this who who this python use training test
words python validation that validation cat this validation training words this python cat that who	cat use this use cat training test use words validation
words use cat this use cat validation this that that training that cat that words	validation who this use cat training use cat training cat
cat words words validation python this cat training who this use that validation cat words	use test that words cat validation python python cat python
validation that cat use words use validation who words this use use python use use	validation that who who validation test words that validation words
cat cat cat validation who training test this python who training use this training training	that words that this this use who validation test words
who test who training test cat use use use training training cat training cat python	validation validation training who use cat who validation test validation
training validation use training test this cat cat this test python that training this use	use cat cat python cat cat words test this words
words this validation that cat who this words this cat use validation cat validation use	python who this cat validation use use words python cat
training this python who training cat training validation cat this test cat who validation words	python training this training cat who that python use validation
test that cat cat who use cat that validation who words python use words python	validation use training test that validation validation training cat this
that this validation validation python cat cat validation use cat python use cat cat this	that cat cat who python test training python that validation
cat use this cat cat use python validation use who cat training training test who	training validation test python this this this test validation who
cat use that python cat words cat words cat use words python words training test	cat that this this this cat validation words cat cat
that who validation this that who words test that cat cat that this validation cat	validation test test this training this cat this words test
cat python this cat words who who validation words validation python cat who cat training	this who validation test who use test this that cat
use that test python use use python words words this python validation validation python this	cat test test who training validation words that training training
validation words words who that who that who training test training this validation use training	training cat training training validation cat this this validation words
cat use cat cat validation that that words who words that cat python use cat	words words that who cat validation training words training python
words cat cat validation who use use cat that cat this cat that that python	who test that cat words this test cat python python
that use test validation test this training cat cat who cat that python cat cat	test validation test who python training use validation cat cat
cat test cat training python use that this use use words that validation that this	validation training who cat who cat python that python who
this that test who this cat test who use training cat this use test cat	python cat use test cat training python validation training this
test words training use test use python this test this that cat training words cat	this use validation this cat use validation python test who
this words use python validation test this training cat training cat this that training cat	test validation use test validation validation words words that cat
this cat cat cat python test validation that use python training this training who cat	validation test cat training use words python words training cat
this validation words training test test cat cat words who use this training cat test	that python cat validation words validation python validation python that
cat cat test python use who who who training use test test cat test training	that that training who use use python test validation test
test python cat use words cat cat validation who that that that who words cat	words test who cat words this test this this words
test cat cat use use use training that validation python who python validation validation use	cat this test that that words this cat python validation
that validation that that cat who python cat cat cat python training cat cat who	python cat python words who cat test this python this
cat that cat training use cat python words training this words python test who test	words cat test words validation validation who that python validation
training test cat words who cat who who training that training this use validation training	use cat this use words python who words cat this
cat python words cat this this who cat cat use cat cat that this python	cat this that test cat test python that this training
words cat test cat test python cat cat cat training this python cat validation that	cat validation words test that words test use cat cat
training test use who python cat python validation test cat this test validation test cat	words this python who who cat this use training python
training cat validation training python training cat that use test that words training test who	words who cat cat python python training use use that
use who who training that test training python validation who training training words python python	python words training that validation who test words validation test
validation python this cat python test cat python cat use cat cat cat who cat	words use python cat training use that python who validation
this test this that training validation cat use use training test cat training that use	that who training that validation cat that cat validation validation
use validation this words training cat cat words that cat cat that that that this	python validation cat words that who validation words cat that
words cat test who use validation cat that validation cat validation cat words python test	who words test training use use that validation who python
words use cat cat use use that cat this training test validation test words validation	training this words who validation words who python test training
cat cat training that who cat cat cat words words that cat training use test	validation that test test that who this this test that
this training python who cat cat this test words use who this use who cat	test cat words words validation who words this this use
words python test who that cat validation test test validation who this who training training	cat this training python cat training words test test cat
that that this validation test cat cat who use words that words cat python cat	who who training python cat this training use cat this
cat words python validation this use words training use cat words python use python validation	this cat words test validation validation this words training training
validation cat use who validation validation python this python python cat validation python python words	cat training who training training who training use training words
test who training test test use that cat training this training cat cat use test	that use words that cat training use words use validation
cat who cat cat test that training cat cat validation words validation this training cat	python that that words use this training cat who this
python words cat python test cat python cat validation that cat test use this validation	test cat words use python words cat test test python
cat this training words use who validation cat use validation python cat validation use this	who cat python cat who who cat training this who
words cat cat validation this this cat this who test cat cat who test who	use test that that cat this this validation use cat
cat cat words test words training words that cat words python test test training python	training use validation use training this who words python test
words python use cat python that use who cat cat who that use training cat	training test that cat cat test test cat cat training
who use python this this that use words training use use test this validation this	who words cat cat cat that python cat validation training
training who this that who cat this cat validation who validation use use test use	cat that test validation cat use cat that training training
words use this words words use validation validation test this training who words this cat	use cat training training python validation this cat test that
cat use training who test cat validation that python who training validation who who that	python cat this words validation validation that test cat that
cat python validation this this validation cat cat python cat who this training test cat	that validation cat that cat who words use words cat
test python words words that training that this who cat python test test this python	that cat python use cat who test training that who
that who test test training validation words who use validation python this who cat validation	training test training cat test cat words that cat test
cat python cat use that cat training this test training test python words that validation	test validation validation training validation test who who validation this
this validation cat cat cat that who test that cat python test that use test	who who training validation use words this this training who
training words words validation test that words training test who cat validation cat python validation	this who test training words that cat python python test
training this use that use that validation that test use use use cat cat this	cat validation that test this that training who python cat
validation training python cat cat that test cat cat validation who cat training training this	test who that cat validation use words python this validation
python that words training that who who cat this test use training python this cat	cat test that that words cat words test validation cat
test words validation test use cat python that this python cat validation this words use	cat cat words that use words this python validation words
training words python cat python that python cat that python validation who this cat validation	use use cat validation this words training validation validation this
use python that words cat cat words this words validation who training test test who	validation words cat training cat python use words test who
test cat cat use validation test cat that cat use training python python words cat	this cat training use validation validation use test words training
who that words this python python that test training who this training this cat use	training python who python validation cat words this python test
validation that words use that validation that training validation cat who this test that use	cat cat this cat who python cat who use python
words who use words python that test cat cat validation python python this use cat	this who cat that who words that cat this training
cat python that training test cat that training who training validation words that python words	python cat words cat test that training python validation cat
validation cat training this who validation cat cat validation that who cat who cat cat	who validation words who this training validation training that python
who cat python cat python use that python test cat this who cat training python	validation this use words validation this words cat this that
use that cat test training words who training who use validation training training that cat	python that that that that this cat use cat this
python words this python test this python this python test words cat who words use	that words cat who python use training cat cat cat
training python python cat who words training words test this who test use use test	cat cat cat training test that this this cat use
use validation use that use test this validation that python who who cat words words	test python who python who this cat use test validation
words cat that words training words that that test words words this cat test training	use use validation test cat words who validation validation cat
who that validation that this words validation who validation python validation this use test that	cat words this that words validation words who test words
python that cat who this this validation who this test python this test use cat	who this that words this training test python words cat
words validation training cat python this cat python this use test that use that python	validation test python test python use cat words who who
this this validation validation test training who test cat this validation test that words who	python that python words cat test cat use this cat
cat python use cat validation python python who cat that who words that words that	test test training test this words training use that that
cat python words use who python this validation training who use validation training who validation	use test validation validation words use who that this training
cat who cat validation python words who this words who cat cat cat cat test	cat use cat use cat validation cat test words cat
who test use who who who that use test training training cat this who who	this validation use test validation words who test cat words
cat cat cat words who validation training python cat cat who validation that cat that	this words who that training cat test who cat python
validation words cat that validation validation validation python python use cat validation training use training	cat python cat cat test words words training python cat
this use python cat cat test test use use words validation use training python this	this training this python who that test words validation use
that validation test cat test who validation use test use test use cat this test	cat test that cat validation this training this use who
cat that validation cat validation cat this cat who use cat who who this that	this training cat validation cat test that training cat validation
that words validation cat who this training words cat python this this cat python who	test cat cat who cat cat use that training who
training who use words python validation python validation python words who that that use words	words this test training validation python training validation that words
cat test cat test python training test validation use cat words python words use use	that training test validation validation who who words test words
that cat who training who python cat that cat words test python this test cat	cat test that cat that cat cat that this validation
validation this training python cat validation validation validation who cat words that test use test	words words cat use who cat test python cat cat
who training test words training python validation that this this cat use python who that	this test use test training that cat test validation test
who training who that test cat cat use python use use this who cat training	words words test cat cat use test use cat validation
that cat who who words training use validation training cat that cat python cat cat	that test use validation use words validation this training words
cat cat cat this python test words test cat test python validation cat python that	words that cat test this validation python that validation training
test test test use this that cat cat cat this cat that cat training python	use this who use cat use python this validation use
cat use cat test training python this python that use cat who that training use	test this words validation this who who words this test
training cat cat that cat words words who use this training words that cat cat	that validation that cat words python this this python who
use use cat this training validation that training training cat training validation training use who	validation validation validation training cat cat that who training this
test cat words words who cat words who validation cat words cat cat training who	that python cat use words python training validation use cat
python who test use cat test words this that use python cat use who cat	training who who cat cat this python cat who words
validation who python this validation this cat validation cat test this cat cat this this	python use validation this this this words cat cat python
who that validation validation this training validation test use use cat who who test validation	python test that python use training cat python words words
who use python validation who words that words cat who who who who cat test	that test use this training training cat words who training
this that who that this training training this this cat cat words that validation validation	words words this training that validation training that use who
training who that words that cat test validation cat python python this training test cat	cat words this this validation training test test training cat
use python use training this words who who use that use use validation cat who	training words cat training words training validation validation training words
test validation python test test this use words words use this python this python test	test use cat python cat that cat that this cat
that who validation cat who cat that this that validation this cat cat python that	words python python words that who validation this use use
use cat python words that that who who training python who validation python validation words	this training use cat cat this cat use words python
this test this test test cat cat python use cat python test validation cat who	python this cat cat cat cat who python who who
training validation cat cat python words validation this who cat cat that training words words	use words this cat cat python words words cat python
python test python test this cat this training training training that who training validation training	training words who python use words cat that validation words
test python this that test training who this who python this this this cat use	words who cat this training words use python that that
who cat who who python test python validation cat this test who words test test	validation use training words this who cat who words this
training test training python cat test validation validation cat test that this python who who	training this words who python test this validation validation use
cat training words this test this python validation words use cat who cat words who	validation test validation use that this python training validation who
use training use that who who validation python use validation use training cat that who	cat that words words this cat who validation cat who
that this who python validation cat that use who python use training test validation cat	training training cat words use cat test this test test
validation use cat cat who python validation training use test validation this cat use cat	python this cat training this this cat training who this
this who validation cat test cat training cat cat this validation cat who validation python	cat cat words validation cat that who cat training cat
use test cat python words words that cat words cat words cat cat words that	cat training this validation cat this words this cat cat
who cat that python use use training test training validation who this training this words	words that words words validation cat who validation cat this
that python words who this this who this use words who test use this test	cat that python this this words use use cat words
cat validation use this cat words who this this test validation python cat validation training	this python test test this cat that cat python who
test use that use python test training training python this this cat cat who who	cat test training python python cat words use that this
training use python words python use cat who who cat test test python this who	words that test that that cat that validation that test
cat training test cat that this use validation who use this this words test cat	who cat words test cat cat test words cat that
who cat training python who use this words validation use use training validation python cat	test training this cat python words cat that python use
cat use cat python who test cat who cat test validation cat cat that words	this who use use that cat training validation use this
validation that who python cat this that python who test test cat this python who	training words this python words test cat words this cat
python training this test use test who this this test words validation python python words	cat that cat python use use that that python python
test use words python use this words this training that use test who validation that	cat cat who test use training words this cat test
validation that training validation that cat use words training validation training this python validation this	this training cat cat cat words test words training cat
cat that cat test python python python this training training that words cat test use	words test words training that cat cat cat cat who
use this this cat validation validation words that that this cat training cat who who	test that words that training this python use training cat
words who cat test training training cat training this validation cat cat this that that	that that this training cat training use words cat python
cat this words use who test cat test test test training python cat cat that	words use use validation use python words who python python
validation test this test cat cat validation use words that that who this cat words	validation python training who python test training cat test python
this training validation python training test use cat use test who python validation test words	test cat words this that words that who test words
validation who cat test that python this use cat cat who validation validation python who	python this test test cat test test python test training
python that cat validation words test test test python this this training cat validation cat	test python words cat that test cat cat test that
that training cat that cat validation that validation training training that use training who who	validation cat words test this words that python cat who
validation this validation that cat test words validation words training validation cat validation test training	this that that training python this python cat words that
test that who that use use training use who cat python use words words use	validation cat who cat words validation validation cat who cat
words who cat python this cat words words cat validation cat words python cat cat	words cat cat use words validation cat validation cat cat
training python cat cat training python that python validation validation this training python who training	who python python test this that training test that validation
test python this who python that cat who that test who who training validation validation	use this cat training words cat cat training cat cat
that words this cat python validation cat who cat cat test test training validation this	training validation that use cat cat cat that validation cat
this python words words who use python this test words training cat cat python that	words training test use use that words cat cat training
that validation python use this python words validation use cat this cat use validation test	training this python that cat test cat test python cat
words words who cat this this cat cat validation use test this use cat training	training words use words validation words cat words cat this
that use that training who use this words words use test cat use test this	python python training training validation words validation validation cat training
cat use cat python training this python this cat python this cat words this this	cat cat who use cat validation use python python this
use test that use cat words use cat use python this test test this this	cat cat this training validation validation test use validation python
training this this cat use words words cat python that training test cat who python	cat use training python use that cat test test training
use validation use who test training that who use words cat python cat that training	test validation cat cat that use this who training validation
this python cat cat cat validation use use words this who that that use python	words training validation python who cat training that python use
cat test training validation that words training python use use cat this training cat training	use that python training this validation this who words validation
validation who that cat who that training that test that words this cat cat validation	python who this training that that use use cat that
use training cat this python words cat cat cat this who that test python use	who python that python test training words python cat python
python that this use who validation that python cat that training who python words cat	cat use this use cat use use training python that
test cat this words python that who use python validation test python who that use	test cat cat cat that this test python use that
python who training this python python this validation use training validation cat this python who	who cat cat cat words cat use training that test
test words test training this words cat python cat this cat cat cat that cat	words validation python use cat test use who this training
that use that who test use this training that validation use that training words that	python cat training cat that use test that cat test
validation use words that words training cat cat validation python training training who cat test	python training this who this validation cat words words this
words use words who cat cat cat use cat words who this cat training python	cat python words use words who validation that words cat
words that validation words test python training test who cat use who cat who test	cat use cat who cat words validation this validation words
validation training cat test this who this use validation python use who test who that	training use words cat this python validation test who python
test python this use that training use words use training words cat that training who	training training cat test cat cat this validation validation cat
cat this who use validation words words python python training validation python cat that this	use cat training that cat training training cat who words
cat use cat cat that use training use cat cat training python this that test	python this this test cat words this who use who
use python who cat python training who words that cat use this cat validation validation	cat this that who words cat cat test use use
this cat validation validation training test test cat that who cat that this training that	use who cat training training that cat test training cat
training that python that python cat this validation that cat training validation who python validation	who python validation validation cat training cat who who validation
test who test that test use who words that python that training cat this that	cat cat this that use this cat use this words
cat training test cat validation test use cat validation who words this this cat this	test use training test words words test python cat python
test cat cat cat validation training this training this cat words python who python who	validation use cat validation validation cat python cat validation validation
cat cat training that cat validation words training test cat python validation python this validation	cat that words python who cat cat cat cat use
this training cat this that cat training test test training cat cat test training training	this who use that cat training use who this use
that training that validation use validation use this test validation that words cat training words	test who use test cat that test test use cat
who cat test cat training training who who validation use training use python use cat	cat this training test training python this cat words use
words this training training cat that use validation python test who use training this that	cat words cat python use training words words that python
cat validation test training cat that python cat use validation python training validation python python	use words that who cat who who test that cat
that words test validation cat use that cat cat validation validation this this test cat	cat words validation words who cat cat validation test this
test that cat cat test cat who python python cat use words that that training	validation who training use test training cat training training test
test cat use test cat python validation that test cat cat that words python who	training use this words cat cat validation validation that use
cat validation cat training validation validation that python cat that this use this that that	cat words python who cat who this test test who
this this cat validation python who cat this test test use cat this this training	validation validation validation words that this cat use words cat
test who that that cat use that who words cat words cat training python training	cat validation test cat who this validation test words cat
python use this validation cat test cat test test this test test words who test	this this words cat cat who use this cat use
this cat python use that python python cat who use cat test cat that use	words validation cat training that validation python test training training
test words test validation use python python training this this use who that who validation	test training use validation python training this cat cat validation
words who python who test test cat use python who use this who this who	use test this test words this cat who who test
cat validation use python words training python training training test who test cat test python	use training cat python that who who this that training
that validation python this words who words validation this words this training words who use	cat test validation cat who test this that words this
validation test python validation use python that cat who cat words that training training cat	python cat who who use that python cat this cat
cat test cat cat who who who training use training cat python use this test	this who use cat that test cat this this python
this that python python cat use cat python python use cat that validation this validation	test training cat who test cat python test who cat
use that that who cat cat that this training python this cat use this validation	words validation cat who python use words cat words cat
this that cat test cat python use use that that training training validation words training	cat test cat this words validation that use words validation
python training use who who training use python words validation words test validation cat that	cat cat validation validation python python cat python cat cat
training python cat cat words test that that python validation words cat that who training	cat this cat cat use this use validation python use
words test use validation that training python validation words python cat this cat python words	words validation cat validation cat this who that that test
who that words this cat words test use python this that that test that cat	use use this cat words words this that that use
python who test validation this test who who test this who training training test use	words python use test that python cat who test cat
that who cat who cat training validation this who cat validation that cat training cat	cat test words who that cat who words python use
cat who cat use validation python training test validation cat this cat that cat cat	python test use test python words use training words this
who test validation cat validation who cat that use test validation who cat use python	words training this cat words cat that python use validation
who cat use python training python this that test this validation this use test python	this this that validation who that python validation test who
words that who test who cat training validation validation cat training cat cat cat who	who training validation training cat cat training validation cat cat
training cat this who training python cat cat training words test words who cat cat	training use cat that validation cat validation cat validation this
python that validation cat use this who this test that cat use that python words	use words validation this who who who validation test use
that python cat cat training who who this test training test who words words use	use validation words cat that who python that validation test
this words that that training python words who cat who cat test validation use this	use this this training use words who validation words that
training that test validation training cat cat use who who python who this cat python	test use cat training cat python validation python training that
cat that that test test that python this use words cat that training that this	training this validation python this cat that cat cat who
cat use validation validation this cat test that words python python cat that cat cat	cat cat validation test test words words cat use who
that test words that training use python training cat cat validation this words training this	test cat validation validation words test test this this cat
this words use cat who test that validation training who this that training words cat	cat validation python cat validation python use cat who that
who that test training this who cat validation training training python test words python this	use words training validation cat test python who that cat
training words cat training who use validation validation python who use words test validation python	cat who training cat who that test validation who cat
words cat cat validation cat cat training cat use training who use this validation who	cat cat this cat words this training that that use
validation test test test cat training who use validation who this use validation test python	use who that use use validation validation cat who use
cat use who this words words training cat words cat who this words use use	python cat python cat words validation use validation cat who
training python this who test test test use training training words use cat training validation	cat cat cat python python training test that who training
validation python who use cat that this that cat training this use test test words	cat use who cat use who that cat that training
validation who this words this cat cat who use python test words training words training	words python validation that use training cat use that training
that test cat cat validation validation cat training cat that test that who python who	cat that training python cat training that cat that cat
python who python cat who this cat test who that this cat words this python	this validation that training validation who words cat use cat
cat this cat this this use test that python validation validation this python this cat	training cat words python cat this validation who cat this
python training validation use python validation this cat cat validation who python who training training	python cat validation python that use cat cat python that
python that cat cat cat that python python who that that cat python training test	that use this use test cat cat test cat words
words training test training use cat validation validation validation words validation test that words training	cat that python cat who validation training who training this
use who validation cat use use words words who test cat python words that cat	training use words test test who who use python who
who use cat use that use this use cat cat validation use python words validation	python this cat cat test this test this words use
cat training training cat test this who words test training cat who use training python	training training python that use use python this this words
use test words this training cat python that words words words cat use cat this	that this validation cat training training use validation this that
use this validation who cat this cat cat python use that that training that who	training that that this cat cat cat this test this
test python that test cat words validation this use cat that use that use cat	training test validation that cat who validation cat who validation
test use validation python cat use this use validation this test use that words cat	use cat words this validation training test cat this that
who cat validation words that cat training python words cat words cat words who python	that cat cat cat who words this cat test cat
who this test who cat who that cat that training that python who this test	validation test training test this python that validation that cat
who that test cat who test words this cat words that use who validation validation	training who cat training this this that words use python
words this cat that cat validation words words that this training validation that validation training	validation that validation training this who cat words cat validation
cat this python cat validation validation python who who words training validation cat use cat	test training test cat that test words python cat who
who use training python cat validation cat who that training training python validation who cat	training this python python cat training validation python cat who
cat who words that who training training cat test training cat use python training training	test words use validation use validation words words test who
who this cat that cat test validation validation that training this cat validation this python	that use words python cat cat words cat cat cat
cat python cat who training cat use test this python words training this use words	that training this python validation test cat this test words
who training python use cat test words training this cat use who this validation use	cat this validation cat that training cat test validation that
who cat python that cat cat this who this validation cat validation python test python	python test who words python who test training validation cat
cat cat that that validation this training python who python words python use words this	training use test cat use words words test use this
use words validation cat test python validation this cat cat validation this cat cat who	cat cat that training python words use that cat training
cat python training that test words use who training this python validation cat use that	test validation cat words who python python who this validation
training test python words that cat cat that that use who that validation this cat	words words cat use use who use who that this
this words cat python validation words python who python cat use python validation that cat	this words this python training cat test that words python
this python words python who cat who that cat cat validation that who this who	this use cat this cat who python that training cat
this training python who words words who cat training cat test this words that that	training use validation validation who python cat words validation this
training who that use cat cat test python training cat cat words who who cat	cat training use cat python cat this use test cat
words python python this who this validation training this this test cat cat that validation	cat use use cat cat python this this words test
training training that validation that this validation words use words this use test validation cat	cat use test this python cat use who training who
this words training words cat this python training that test who cat cat that cat	cat words words training training validation validation cat training words
training python validation cat python that this that use python test cat this that this	training this this test who cat cat cat training cat
python python cat test validation who validation this this this validation training who cat who	use cat validation words python who use python python that
use use this who python validation training test python this who cat words cat who	validation cat who training validation validation use this words training
use this cat that that training python that who that cat test test who test	validation test cat training who validation training validation that cat
test words validation use who training cat words validation validation training words that that use	cat validation python cat validation words test python test test
python that use use cat that cat use cat cat test words test validation this	cat cat who this validation use test who test words
validation test that who use cat words cat cat this cat who python training cat	python who test use cat words validation words test that
cat python this cat use training python python that test test use who test validation	cat use cat words use python training words use cat
validation cat training test this words who words who cat words test words words cat	cat words words cat that who training test this who
this who words who test use this this words who python validation words test cat	validation validation cat this use cat cat use validation use
use cat that validation this training cat this this this use python training training cat	use test that python this use python training python use
cat cat test test cat words that who cat words words that this words use	use that python test training validation who cat that this
training words words use cat use who use python that words who who words validation	words python who use words use that cat validation use
test words cat training who words training cat test words cat test this words that	words this test test this python words cat cat that
who who cat words this this cat cat training this use training cat cat cat	cat words python test this words use cat python who
training words words who that this this that python cat training python use python cat	use cat python use validation this words test python cat
use python validation python cat cat this that python who python this who validation validation	this that validation who cat cat use that cat cat
test that python cat test training python test training this cat cat test validation cat	cat use cat that python words words cat this use
training training use python words words python words cat validation words use training use validation	cat this use test test use cat who cat test
validation training cat validation validation use who python python test cat words who use validation	this validation training cat that who python cat that use
training words test who python training words who python cat cat this python cat validation	python python python cat training cat training training this who
training cat this who python cat validation use cat who who cat this validation training	cat cat this cat validation cat use use python words
that test test words who test who validation that cat use who who this validation	use test this cat who training use this that use
who words cat use this test who that cat this words words this this python	use training use that who that cat this cat cat
training words cat training who use validation that python cat python validation words cat python	cat training training python cat training validation python words test
this cat that cat python validation training cat use words use words cat training python	validation that words cat validation validation cat validation that cat
words validation that validation validation words training training that that validation use cat python training	this test cat validation who cat python test cat that
use words python test python cat test who who that words who use test validation	who validation words test training cat this validation training validation
who training that python test who who cat validation validation validation who this who test	test validation test python words who test this cat training
cat python test this who cat words words who validation this that who python python	use python this words this who test python words cat
training words validation cat that that use cat that who this this words use who	python training test training python test python use that test
cat words validation training use cat python test who python who python this validation test	that cat test validation python cat cat who that cat
words who cat that who use cat who this use training use who python that	who python cat training validation that cat that this who
cat training use that training this this words use training cat that cat words words	that cat words validation test who test validation cat training
use use training training that cat use python that cat python who use who test	cat cat cat words who python cat use validation test
test words this training training cat cat python this that cat python validation cat that	who cat who training validation cat who python this training
words python words cat this training python cat who who who cat cat who python	words use cat python use training training training test this
words python that cat test use words who this validation this validation this use cat	use that cat cat python test validation words who who
cat test cat training python use that cat words test use cat training cat validation	python training who python words test cat use words who
that that use who cat cat cat this test python who cat who who use	that words python words test use this cat words training
validation validation who words training python that cat cat python test words that that test	cat cat cat that validation words python cat who test
validation cat training cat use training python test python validation python validation use test words	python cat this use validation test who this who cat
cat this words test training validation words who words python who that words words cat	python use this who test python this that who this
this cat cat that who test cat use cat who cat this cat training python	cat test training use this cat that use use python
validation words that this use validation cat this cat that cat python test this words	cat use training cat that validation who words who training
validation validation use test python use training use cat this training words words test use	cat words cat test cat use who test cat cat
use who use words this use validation cat who who who validation use python words	this use who training cat use who training test words
use use cat python validation that python use who use test cat test cat words	training validation cat training cat test test training cat cat
cat validation training cat words training this test words cat words words python use this	who training use python cat who test this cat who
this use that use that python cat training cat use training validation cat words training	cat that words cat use this test python cat validation
python who validation cat test this use who training validation cat use words use training	validation who test that use cat cat cat this cat
training cat that cat training test words words use validation cat that that test that	this words validation cat validation validation use words that python
words training who use cat this words validation cat this test who this training test	cat who words words words words training python use cat
that python use words that cat python that cat cat validation this who cat validation	this words who training test words cat words training cat
this use python validation this that use who cat cat training who this cat words	who cat this validation cat who validation training that validation
validation test training training that this words words cat training use cat training cat cat	that training test words words this cat use cat validation
training who test python who words python cat cat words training this validation cat training	this use this that python training test cat training who
validation that use cat validation training this cat words cat who who training validation cat	words use test this this python use test cat words
python words python that cat words words this words test training this words this this	who validation test use python that words use that test
python that use that use that who words this validation words words that validation cat	python cat cat cat training that validation training training training
test python who cat that cat training python training this this training test python words	python who training who training test words validation that python
test that this python cat words that words python cat test that use that validation	python test cat who this that training python training words
training this who who this use training validation validation training who this cat use python	this cat this test this words this validation words who
test that this validation training that python this test who validation cat training that cat	cat cat words validation cat this python this python test
test test test test python cat cat cat cat validation who validation python validation that	cat words this training that validation cat words who that
test test python test who this who test that words validation who use that this	who this test use cat who python validation use cat
test validation use cat cat that who validation python that cat cat this this test	that who this training cat words that validation who training
validation use python who test cat cat that cat validation training cat words that test	validation this this this use test training that cat this
validation use use python who that cat python training python cat validation test test words	who this that words validation python python words training who
this that that use test use who cat this words words cat training training words	python cat cat cat this test cat python that training
test cat who who training this validation who training that python that use this test	cat cat validation validation validation this test cat this who
who use words cat this cat cat that words words use cat cat test cat	cat use training cat test test use python who python
training python who validation use use who validation test validation test test use python validation	python words cat that cat who who cat python words
who that cat that training training use words this cat use cat who python validation	training who cat python this that cat that cat training
cat use use training this test python words use cat who cat cat this words	python validation words validation cat cat training who this cat
this that use test python this python python that words words that validation training cat	python python cat cat use validation who training this cat
cat test training cat cat cat python cat this cat that that this test use	python that who words words validation test use cat use
cat this words words validation python test words use cat words validation this who cat	cat use that test words python cat use test cat
python training cat test cat cat training that cat cat cat python training who validation	who this cat test this who training cat cat who
python training python training python training that that use that cat cat that training this	use that that who cat cat python that this cat
this who test use cat python who python python words use who cat that use	that cat test test python test this validation use cat
who training words this training test training python training python use test python cat cat	words cat words python cat that that who python cat
python python cat python this cat training this training validation test validation validation cat this	use who training who use python validation who validation who
that python test who validation cat python test test who that validation use use who	that words that validation validation python training python words test
validation training validation python words cat validation use cat use training validation this words cat	words use validation this python use cat who test use
use training training words python who validation who cat who test use that who cat	training who use python cat training cat training words cat
python test words that words training that words words this this cat use training use	words validation cat validation training words words words cat python
that that training validation validation who that test training training training that use that training	who training who this cat python who this who that
cat cat cat that this test use cat that cat cat use training test python	that test cat who cat training test words cat words
python python use this python cat test who training validation words training test words test	that training validation use this python words cat training words
training use words who words use validation cat words training training test python words cat	who cat training this who cat validation training use python
test validation training this that words training use this that words cat training this training	python python validation validation use validation that test python validation
cat validation who who training cat cat that who training that use who that cat	test validation training cat training this that validation python who
training who words who use this who cat test who training use this who validation	validation cat test that cat test cat test python cat
this cat who words test that this who validation cat this test training training cat	cat this use cat validation who training who who python
validation cat python training validation training cat test validation cat this training use cat use	words use this words validation training test validation test use
use cat this validation cat this validation cat use this cat that this this training	python test cat cat who validation who test words who
validation test cat that validation who test this use training validation test validation python validation	who training python use words that python training training training
test training cat cat cat cat words training test validation that cat test validation validation	words that words cat cat words this use python that
cat cat use cat this cat that who cat python words validation validation training this	this who words use training python test use cat who
cat cat that python python use words test that words validation that who test who	that who cat training that words words python validation cat
validation words use cat cat python words use training that validation that training this cat	words that this words words who test words validation cat
this training validation who this training words who python test words use python test training	validation cat python use use training test training this cat
training test this cat this validation cat words words cat use cat test test use	validation who cat use who who that cat cat cat
words that training words validation test validation cat this use cat cat this that cat	this this test training validation who python test cat words
test cat cat training training test validation cat cat training cat validation that that that	who words use use cat training python validation this validation
words test use test that who this cat this who who that this cat validation	use this cat that cat validation this who cat test
cat use this who words cat validation validation cat cat python python this cat cat	python use cat validation test python that test use validation
validation cat that words cat words words cat this python who use who who validation	training training validation this who test python words that who
words who test that that use cat cat test cat test use validation who cat	cat cat python test who training this who test validation
training this that cat who this python cat cat that test who use validation that	training python python this python use training python use who
use cat this this words who test test cat python use training cat that who	use cat words use test python that cat this python
use cat python cat this that this who test words training training use use cat	cat validation who this who that words this use validation
validation this training that this cat cat training that who that cat cat that that	python that validation training this this use that that cat
use cat words test python words validation use use cat cat cat validation this cat	words this test cat test this python that python use
python use python validation who words use words validation cat training this training cat cat	training validation cat use use use python validation use test
words this cat who use validation cat words test words this validation that test use	training cat validation test who test python cat training validation
that this python use cat test this cat cat test cat training words python cat	test test this this that cat this words cat python
words validation cat validation use cat test cat python validation use training validation cat this	validation cat python training use use python that this that
cat use validation python cat python cat python python python cat python that test python	use who test python python python cat test words python
words cat this cat cat python cat cat words use use test validation use cat	test who words use cat validation cat training this training
validation cat cat use words that that python cat that test words cat validation cat	who validation words who training cat this who that cat
python cat validation cat that cat test use cat cat who test cat this cat	training cat that training who test that validation who test
validation validation words who validation validation cat test python cat this test use words that	cat training words training use python validation cat who cat
training words test that test who this test this cat this python validation who cat	test training this who this cat cat training use cat
test training that use words python test validation validation words words use validation training this	validation who use cat python training test who words training
training training who validation test python that cat who who this that this test training	python use test test use validation that validation validation python
cat validation cat use cat training use this test test test words test words words	that test validation cat who test test test that words
who this cat cat this use test cat words use test validation validation that this	this that use training validation cat use validation training cat
training that validation test validation this python use use python test training use this cat	that python words who this who use validation this cat
words validation python words this that validation python who test cat validation training training words	this training training training test use training that python cat
validation words cat training python training this python cat use validation who training this python	this test cat validation training cat test use that test
cat test this use words that words this who validation cat validation validation training who	words test test who cat training who training cat cat
that this use that cat python use cat python who cat words who who words	validation cat use validation cat training training words this training
training test python cat python words use python this training that this python that validation	cat that training validation cat that who test this cat
cat training training this who training cat validation words python words words validation test this	test test use that training python who validation cat cat
python python this cat cat words cat test this use words words python this words	training words who that cat training cat this python training
cat training training python use cat words validation training words validation this use this validation	training python cat python training training who that python words
who validation test validation who training python training test test use cat python cat use	cat cat training python validation who that validation cat python
validation that python test cat test who test validation cat that validation python python python	training who validation training validation that who that test cat
test cat training cat python this use cat who who use words cat this use	use who cat words python cat validation this validation test
training this use python this cat cat use validation cat use words cat training python	cat python cat use who cat cat cat python cat
validation who cat test cat use training that use this words words python use words	cat use that words that who that python cat cat
test use test cat validation use training training words who that who cat python this	python test cat test cat python python training test cat
python use words this use training words that this validation cat cat this validation words	this validation test use cat test use test validation cat
use use words python training this test validation that who this cat cat who test	cat who that this test who cat words this this
cat cat cat training that validation test training that python this validation training test python	this this training python cat words cat words words training
cat cat that who cat cat that training use training this test cat test training	words this validation who this training that training that use
that test cat this this use validation cat use use training cat cat test use	that who test this use test words words test cat
training cat words python training use cat this that this test this validation validation use	who who test this who training python training this this
python python python cat cat cat training test cat training training use who that who	training cat training test test this words validation words test
who cat words training words cat use cat validation use test validation test python words	test validation use words words who validation that validation python
python who words cat words that words python that that cat who who that test	cat cat test cat who validation training training training this
who cat words cat python words cat this cat validation validation who test use use	that words this who that who that use that this
test this this words cat cat test validation training words use training python training test	python validation words use that this use words cat who
that use use training training validation who validation who test this training training cat cat	training use cat cat that that cat training who cat
python who words test test training who test training cat use test validation python training	training cat validation python that training use cat who that
use cat validation cat words cat that cat this words cat words who cat cat	cat use cat this cat this use test use validation
python test use who training cat validation that python this that this use cat use	python who validation python python this cat validation words words
test training words use words training that training that python validation words cat who python	use who cat words python training that python words test
this use use that that who python validation that cat cat validation who validation cat	python who who use this use test training that words
cat cat cat python this use who words this this use python cat this that	cat python training who validation python cat use this test
cat python validation words use that use that use cat use this validation cat that	cat validation use cat cat use test cat validation training
validation validation validation use validation cat test cat python training cat test who validation who	who validation test that that validation training cat training validation
training validation who who python this this validation test this who this validation python this	python cat who cat words test use test who cat
training python that test python test use test cat training that words python that cat	cat this words this who training python cat who python
python words words validation words this words validation python cat cat python python cat cat	words use words python words python cat cat who training
that use use words python who cat test use cat validation cat cat this cat	this training training cat use that python validation who this
cat training validation words words who use training use that that that this training use	validation use python that that that python test python training
who words words who who training validation words cat words cat that cat words cat	python cat that this who who validation validation use python
validation training use words validation words test training this that cat training validation test training	validation cat training validation this test use words cat use
that training use this python use this that use who test words who who test	this training words use use test training training training python
cat that cat use training this who who training cat test validation cat cat that	cat cat cat test this who words test words python
cat training test words training that cat this use python this who words validation python	words use words python python use cat python cat cat
who words this validation cat words cat this who words python python use words that	use python words test words training cat who validation cat
cat training test validation validation test test test validation use validation who words this python	use this this training words words use python cat this
who python this validation validation use who test validation words that test python that python	use cat python test training use python words validation use
words test use validation validation test this this cat python words validation validation use test	this who cat validation that cat words test use cat
python python python cat cat this who this python use who that python words validation	validation python test python training who words words test test
cat use test cat cat cat cat training python that cat training test use cat	that validation validation that cat validation that who cat this
that python that python cat test validation validation words who training cat cat words use	this use use that python that cat use cat who
who validation use that this python training cat test this validation python test use that	use words words cat validation validation use words validation words
test who training that this this test use cat cat cat use test training this	validation python training use cat this test that test words
this who cat who who training this validation cat cat cat test use who cat	training cat cat cat test python this that validation cat
cat validation cat who that cat test use this who training training test training this	python this test this python who training use that use
python who that this test that that words test test use cat words who python	who words test python that training use validation validation training
who words who use training validation test use who that that that who cat test	validation validation test python test that cat words words training
that cat python validation test python this words cat training cat cat cat test who	that this cat who test this words test who training
this use use this use test use use this cat test cat who who this	words cat validation use who who training cat cat this
this python training use that validation test that use test that that test this who	this who cat validation words python test that python use
use use use python cat that words that test who cat validation words training this	who test python cat cat this words that this words
who words use this test test training python cat use cat words cat that use	cat validation cat training words use cat validation use python
test training python who test that cat validation training this cat cat test test test	who who cat this training who this this cat training
training use this words test test cat who use words this this that that use	validation this this cat words cat python words that words
that cat test this words that cat training use use python python python test use	python cat use python who cat who words who use
python test who python cat that cat validation who this this words this who python	use this cat test python that cat words cat training
training python cat training test cat cat use words this python who that who who	python this who test this who validation this validation test
use training cat training validation use words who that use test that that cat who	python use words test validation validation cat python python test
cat validation test validation training training python training test words cat use words python cat	cat validation training python training that training test cat training
python python that validation that training cat cat python that cat training python who training	cat training words who who validation cat who that test
that training cat this who cat cat cat words use cat this words that cat	words test validation who words use words test use that
words cat python this cat who validation who test words who cat python cat test	validation python this training that training use this this cat
training test words cat cat python this use use test training python this cat who	validation use that test that cat cat use who test
training cat this test test training cat who who python use who python use test	cat who that cat test python validation validation this training
who use this python this cat training words this this training this training use this	cat python that test cat training cat cat training validation
words use cat python that that that training cat cat python python use training use	who words python use cat validation that who training test
validation that that cat test this python that this test use validation cat who use	python cat training use this test python words python this
cat training words cat cat that cat use training this test use validation cat cat	test training training use words that use that who training
training who python cat that words this use that python cat words words words words	words words cat validation validation who use use cat training
test cat words this validation this this words test training python that words test who	cat test who that words this cat python python who
cat words who cat test use training cat words validation who that python words who	that cat words this this python validation who words words
use who training validation cat words use training cat cat cat test python cat test	training words this who who cat python use that cat
test cat validation cat who validation cat who who words cat cat cat cat use	this this that python python words words validation training cat
that words cat validation use that who cat python training cat test use python python	training cat this words words validation validation who test validation
words python cat this training test python words training test who test this cat use	cat cat cat who training cat cat words words cat
this python training who cat this who that that that words python cat python cat	use training words who this cat words cat python use
this test words test who this use test cat that test training who use cat	cat cat that cat use training use use words who
validation cat words this who words words that that that who who cat use cat	use words cat words words python cat test python test
test use who cat cat python cat who test this cat words use this test	that cat training cat python python who python cat use
use training words validation words test who validation test words cat that test validation this	validation validation test validation that cat that who cat python
use cat words words use words that use who cat use training who words cat	who validation who who this training words python use that
test cat python words that python cat python that words this who validation training words	training training cat test test that cat validation that python
that cat test test that that cat words cat that that use test who python	that words words test this who validation use training this
test training who validation use use words words who that training who words that that	use cat that validation that this python test that cat
cat cat cat that training validation this test that this this python this who words	python python that cat test cat python test validation words
python words validation who cat python cat test python use who this training that words	who cat test words cat cat who this this cat
cat words cat cat words words training training validation use words training this use validation	that cat training who that that words that words validation
training this validation cat words validation cat use training words use python test use cat	words that words python test python test cat who this
cat cat cat validation python use use words that use words validation cat training this	words cat words words python that words python that that
who python words python cat test training who validation cat this validation cat validation cat	that who use words use use use cat this python
training who cat cat cat that that python that that cat cat who who training	training this words who use test cat test cat who
test use cat words words cat test words validation this this cat test python who	validation training test use who who that this that cat
this that test cat validation training this this words this that words test words cat	that who validation python cat validation this who that that
that use validation words test who use cat this words python this validation test training	this use test words this that this python that test
validation validation python cat that use words who validation cat training training validation python that	cat test that cat cat training cat this words use
cat test that this that training cat words words use who use use who this	validation that cat use cat test validation python use words
words who this cat training this python cat words words cat this use use cat	words test words that who validation use training that this
test cat cat who this cat who use who this test this that python test	test that this that cat python words cat who cat
cat use test that validation training validation python who test training who use this cat	cat training words use words test python use use test
cat test python cat cat validation cat training validation this this validation test python use	cat test training cat that test training training use use
training use this cat cat that training cat python cat cat who words test validation	cat test that python cat cat cat that this who
use who that training words validation who test cat test use who who words words	cat this test python test who that validation cat training
this cat use training cat training validation this words words words python this training who	cat training who cat words cat use python use training
that use validation cat python cat use use that cat python words python training this	python python words test test training that that words words
python python this validation words use this python use cat words who cat python this	words cat use cat training cat who who training validation
this use training validation use test that validation validation this that that words validation training	that who training this validation cat cat python cat that
this cat who training python python training that training validation cat training cat this python	training who use who who python cat test use test
training test that who test python this training validation who training cat python use python	use validation cat validation who validation this this cat validation
validation python this who cat this validation cat use python test training cat words words	cat test python python cat validation use python validation cat
cat cat test use cat who cat who validation cat use words cat test python	use test cat words that that cat validation cat this
this cat who validation who cat use python who words this cat that that python	training training cat test test use python training words training
training test who this who words who that this python use use words validation who	that python validation use cat cat who training training who
cat who validation python this cat training validation training validation cat use words words who	validation that training validation words test that who python cat
use validation words cat validation cat this python words this validation who test who that	training training this who python test who test cat cat
that that use training test words cat who python who validation use use who python	this cat python validation use cat words test training python
cat that words use python python this this python that that words python test test	that words cat words who cat test that this cat
who this that cat words cat who validation use python this use validation that this	cat words training validation test cat python cat training test
who cat who that validation cat cat cat who test words that validation that words	use training who words this cat cat python test cat
who python use test python validation test training python cat training python use python use	validation cat use cat who who validation that that that
this use that who cat cat who words who that who this cat use use	use that test test validation validation cat cat cat this
python validation python cat test training words that python use cat use training cat python	python words use that words that this words validation validation
words training cat cat test test validation words who validation training test words that validation	validation words this validation cat words who use that who
that use that who this words training this cat python cat this words words words	words this test cat who cat words validation that that
use this words python validation python this python that training python validation words who python	cat cat training that cat this that use that use
this validation cat training cat test python this that cat words this words who words	use use cat cat this that python cat validation validation
use training cat training that training that test cat who this python use use python	python cat python cat use cat cat validation cat test
that python this that that use validation validation who who this words this use use	test words words who test cat that training test who
use who test python python use test cat this validation words cat who cat test	python use validation test validation validation python cat use test
python validation test that words who cat test words python words that training that cat	validation python that words who use use training test words
cat cat cat training validation words who who who words that who that python words	words test python training validation words cat that validation python
test this cat this training that this validation use that use python this words that	that cat use that use training this training who cat
words validation validation cat who python cat this cat training test use cat test who	that this use test this python validation this cat cat
validation use cat this training python test validation training that python who python test python	cat training words python that this words this that this
that training training python python cat words who validation test validation cat words use words	python test python training this validation that validation validation who
words words python validation cat python python cat that this cat python training training test	validation cat cat who that validation words validation this who
who cat who use cat this that training that python that cat use python use	that cat python validation that this python cat who cat
validation test who python validation validation cat python this words words this words this test	validation who test words python this words who use training
that cat that this cat cat cat cat test training cat that cat use words	cat that test validation cat who who cat test who
test who cat training training python this python this training this this python that cat	use python validation test that use words test who validation
cat cat who training this use this test cat use words cat cat words words	this training use test this test cat cat cat that
that training this use words use that cat this test test test validation words python	test words cat that cat who cat who that words
this use cat python words validation python who validation cat use who that test cat	who python training training cat training cat python cat who
words words this training that use validation validation test python this who training python cat	python python this python who cat test words cat this
words python training use words cat that words words validation python cat that who who	python training use validation words who who validation use that
this validation test this that words validation use that training this test use use words	that cat cat cat use this this cat who use
test this words validation training python who this that test this use who use cat	training words that validation this use that words words that
validation python cat test this validation validation python training validation words use training use training	cat that who use cat validation training who who cat
cat that training python this cat python validation use that cat that words training test	test cat cat python who who that training who cat
test validation this use that words cat that use validation that validation who cat who	use cat validation use use test words who cat use
this words cat that python this use this cat words training cat this python cat	this who python validation who training python python python that
that this validation who use use python words who validation use validation training training this	cat who that this this test python python words cat
use words use test use words who words words who test this cat cat that	test training this use validation cat validation who test test
python cat words cat validation words test cat validation cat use words training that python	words this test python cat training words this who that
cat that test training cat use test test words python words validation cat training use	training this python validation who validation that use cat test
words cat python that who training who that validation use test validation validation cat who	validation test validation words who who cat this who cat
use this who that test this that cat that words use words this training python	python words that cat cat use test python who use
cat cat python that test who this test use who words who cat use test	training cat python test cat use that cat this words
this words that validation that training who that that that use python this cat test	training test this who validation words use who training validation
cat test validation that use validation that training that cat training python words use words	cat this use cat cat python test cat use that
who validation this training that cat who that words who cat test cat words this	python cat cat test that cat cat python validation use
python that test that test test validation validation that this that words that who cat	validation validation cat this use this training cat cat this
who validation words who test who training this that training validation use test this python	who that that that this cat who cat that cat
this validation use cat words who cat validation this that python words training python this	use cat cat use that use test this words validation
cat who words python training python use words that who validation cat validation use python	that this who training test cat test validation training validation
python training validation this cat this this use test use test that use cat validation	training python python who test cat test use words python
python that cat cat python that validation cat cat cat that cat cat words that	use training validation training test validation that this validation that
use who that words test who test cat python validation cat who words who validation	training who cat words training test that use this words
python validation cat test use use this python that use this cat cat use training	cat that python cat validation use use cat cat validation
use words cat use training cat that that use words who cat validation who this	this test training python python use who training who words
who test cat cat words training that words use python words training use test who	who cat cat python cat that use cat training words
who cat this python this that use use validation that validation python cat cat cat	validation this words that who test words that training that
cat that validation use who cat that cat use cat cat this python cat use	words test test validation this words cat that cat test
this test cat test validation validation this validation validation validation words test cat validation words	validation words python training words python validation cat python use
that who who test python that cat words this that use training that words that	that test use test python words that use use words
use this validation words training words python words cat words validation python cat python this	that training validation that this python this test cat validation
who training that validation test that words that cat validation use who use who that	cat test cat test cat words words python use test
cat who cat training test that cat test who test python test who that python	validation this words training training python cat cat this use
this that cat this who test that words validation use that that training words use	python test validation validation cat that use who training this
use validation who validation use validation that training cat training who training who training python	use words this this use who python validation who words
cat python python training training validation cat python cat cat this words cat training python	cat training validation that cat cat test cat cat training
test training that who use test validation validation that who words that training python training	python that training cat cat test python cat cat python
python words that validation test validation python this test use use words cat words cat	words that who validation python this words use who cat
use words use words that that cat cat who who words that cat test words	who this who cat validation test this validation python this
cat validation validation that test words that that training this training cat cat who words	words training test this that who this cat validation that
cat training use test that that who use who words who this use validation cat	cat that cat python use test test training training words
training that this use words this validation who words use test cat this that who	this python cat python validation python use who that that
use training use cat use cat python that test cat training that who this cat	that cat validation cat validation this this test training validation
who cat this cat training validation training training test that this python python use words	who words that use this cat test python python test
python who validation cat cat validation python python this cat this cat python training validation	cat validation validation this cat cat cat cat words this
python who python words python that validation python validation who validation that test this who	words that validation who python cat training use training who
use cat this training cat validation this use cat python test test use use training	that use test test cat training cat who use cat
that cat cat this use training use training cat cat that words test that this	cat words training that who test use words python cat
cat who this who validation words cat this use use this words this who python	that this use cat that that test that who cat
who training test test cat use cat who words use validation who this words validation	use training cat who cat python training test that cat
who training who words that use validation validation cat validation cat cat use training use	cat use words that words python who training cat python
test training who cat training use words who training that use that that words python	cat test validation cat that cat this words test python
cat who that python cat this use this python python words who use this training	validation that validation cat that this use that python validation
this cat python that use cat cat cat cat use test who validation python this	words test test who cat python test who validation that
cat use python who test words who test test python training training test words who	cat words training validation who training use test validation use
python use use that validation words python test use training python words who this who	training words cat cat python python use cat use who
use that python cat that python words words this test this that cat who that	that words cat training training that test validation training cat
python cat cat words training cat cat that cat that use that test cat training	who cat test validation this cat who validation who training
test who training words training python words that python python cat python use python cat	who training that cat cat python that this this that
this validation that who validation use validation cat cat python training cat this words cat	use cat that test cat python python use cat test
words use cat this that python words validation training test cat this cat words cat	python use use python cat training cat python words training
validation words this cat test training cat words who this training validation validation python that	cat words test training training training cat cat this that
test words use test validation cat who that use words validation training words test use	that cat cat cat cat who training who validation who
use that python cat that python training use test this words words that words python	training test python validation who this use python use words
python python validation words who training training this training training test who training training cat	validation python that test cat python python test python use
use cat cat training who cat words training cat test words that python that words	python that who test that use cat python that cat
test test this who validation use cat this training cat use training who training use	validation words cat validation python this training who cat validation
training python training cat use python cat that words test validation that words python training	who this cat this who test training who test this
who validation test validation cat cat cat test who training cat words use use use	validation cat cat use use python training python cat cat
cat python python cat training validation this cat that use that this validation who that	python python use training python use validation who training cat
cat validation words cat cat use training use who words training python cat python cat	cat test use test training that test words cat words
words who cat this words this use training use use cat this python cat this	use this that cat that cat python that use validation
use use test this who validation cat cat cat this validation that python who test	test this words that cat training cat this this this
validation test validation words cat validation that words validation training python python validation cat use	cat this cat cat who validation words that words who
validation python use training use who use that use this training that words test cat	words test that words training use this who validation training
training who python training this test this words validation cat test training validation use training	use that validation python who test cat cat who use
python this that python who validation this cat cat test training words cat python test	validation words python cat cat this python cat cat python
that cat who this that validation use words validation who that test training words words	cat python who use cat words who who that cat
training use python who this test words cat test that use python words python cat	that that who cat python use python training this validation
python words python words cat validation that validation use python training training training cat use	python cat test use cat cat test training test who
cat words use python training words cat cat words who test validation training use training	python python cat this cat that that this this use
cat validation test that use validation use words who cat validation use use cat cat	who test who who this test cat words that words
test use cat test that cat that python this cat this cat use python that	test python validation test that this cat training cat use
that that use test who test who words use words cat cat test cat who	cat cat validation python cat validation test validation python who
who words test test validation that validation training that use words validation that test that	python training cat training that this validation this that test
training who use this test words words python python cat who use training cat words	cat cat words python use test that test this cat
cat test this use use training use that words training cat use test python cat	python cat words python that this cat validation training python
use test validation validation this this cat that this training cat cat python training validation	training cat cat use python who python words training use
who that use who words cat training that python validation this test use python words	use who this test that cat use cat this python
cat cat who python cat test validation that training this use cat that this words	cat words cat cat use test cat use this cat
words that cat this that that words this cat training that this training this that	this use use test words validation that cat use validation
validation validation cat use validation cat who training who python python training training who words	this words that cat validation use training that who that
python training test who validation that training python that cat test who validation this training	test python test words training training cat validation cat python
test python who training validation that use training python python cat validation training use cat	training cat cat use validation that words python cat who
words cat cat that python this that this cat cat words cat training use use	use that training who test words this training this cat
words that words training validation that use cat words that words words who use cat	words test training use cat this use python that test
who training cat words validation training words cat validation training test validation cat validation who	use this cat training test who cat use test cat
cat who cat cat python cat validation training who who test python use this that	cat cat who cat cat words this that python use
python that this cat training test training use who validation use words cat training words	validation use training who who words who use that this
who test that who who words words cat validation validation who test cat test test	this training test test use that python who that validation
who who training use training that that words python who this words who use validation	test test cat that use test use training cat use
test validation who use use use python training that cat validation cat cat words test	python test use cat validation words cat words that that
who validation who python cat cat that test python cat who cat cat cat test	cat cat this this words this who cat words cat
cat that python cat cat this validation use cat test python words validation that this	cat who cat training test who validation training training this
test words validation who validation that words training validation training that this words this cat	validation cat this use validation cat words training test training
python use use validation this python who cat that that python who cat use that	use training who python who use who this cat training
python use training cat python cat use training cat training python test who validation cat	who validation who this use use this validation that test
that python training cat use words test this cat cat who cat validation test training	use words that this validation python this training test use
use that training who training python validation python use cat this cat words validation validation	python words test words cat validation validation use training python
python cat this use training words python words training python that cat training python test	cat that this cat that use validation training cat who
cat cat test this cat who use python this python test validation training who training	validation that use use python this this training that python
cat python validation that this python this this validation training training words validation that training	this this cat validation use this this test cat that
test words python training test this test words cat validation who words words that this	use use validation validation test who validation python words this
that test use validation this python who who this cat use who words use use	who python test that that validation that this use use
this who who who validation use training words this that words use who training python	this training test use cat cat this that words words
this who validation validation use who python cat cat cat who this training use this	cat words cat test that words words cat test training
python that words this who that training cat that who test cat that training that	validation who this use use use cat who test cat
who cat python that cat cat validation this use who that cat words who validation	this python test cat that python cat that words test
training words that use words this that python validation use test use who cat use	cat validation words use words use who that test who
validation test that cat python cat cat this training validation who words cat test python	this cat use test python words use training test validation
cat training words cat cat use cat that this cat cat that cat this training	words cat who training cat training python who this who
cat who cat this words cat words cat this that words training test cat validation	python this this cat use cat use cat this python
validation who words who python cat words cat test that who validation cat cat use	validation this use python who this cat that cat training
training who words who validation cat words who this this this cat cat python that	that test who cat validation cat cat who who training
cat who validation that training cat this cat cat test this this use validation who	that cat use python cat words cat validation test python
that who that training cat use this who training use that who words that cat	training cat training validation cat this test this python this
python training cat use that python who cat words test this test words use words	use this training this words cat who that that validation
this validation who use test validation cat test use cat validation cat that use this	this cat this validation cat test training cat use cat
words training use test this words cat test cat this python validation this that validation	python this python test test that that use words this
this test use test training this cat python who test this validation this python this	that cat words cat this training who python that test
words test this use validation python test this who use words cat validation words training	python python who validation test cat this who cat python
this words cat cat python that validation this that use training test cat validation that	python use test cat cat python who test test words
words training cat cat python words validation cat validation cat training test training who validation	test cat words validation words who validation that who training
this test python training that cat use cat cat this words use python words that	that test use cat words validation that cat training this
who use cat python training python words python who this that that who who cat	words python this use test training training validation words validation
use test cat cat validation python validation python validation cat cat cat use python cat	that use who training training words test this cat python
use that that words use use that validation validation cat this words use python python	test words test cat who use that test test who
test this training words cat who who use who who validation python cat test who	this test use cat that cat words use who this
python cat that python who validation cat cat words use this cat cat training use	use python test use this cat test training cat this
use use training that that cat test validation who cat cat validation validation validation python	who this cat words validation test use that words test
cat training words validation cat training words cat training test python this training test this	validation that who that use words cat that use test
that that validation who who that training training who who cat words this test words	who python python cat this that that cat that this
cat that that cat that that python who validation that training test python that use	cat use training cat python validation training training training use
cat words words cat test training cat validation cat that test this that test use	who that python cat training validation use python words that
who this test test validation use cat cat who words that cat this this that	who test test cat this training validation test who test
use this use python cat words cat words python words this this use use words	validation cat cat that cat python who test this validation
validation training words validation python this python cat use that cat python test python python	this use python words training use validation validation python test
cat who python cat training training test words test this words validation test this who	cat test cat cat cat python who words cat python
cat this words words cat that that who cat validation use training this use that	cat cat cat test words who use that cat who
cat cat python that python cat use words cat use cat cat validation this words	python who python validation training use this test python test
that cat training use validation who this cat cat words that training test that test	who cat use that validation who cat test cat use
who that validation that words python who who python who training training cat training who	use python who python this python validation that use this
cat who cat cat training who this that cat test test cat test this this	test training training words validation words who this words that
validation validation use use python use test that use test that that training validation validation	who that cat cat cat cat this cat this cat
training cat this test words python this use this python words cat cat this cat	words that test words this test validation this who use
test that words this training cat validation words validation python that this who words cat	this that python that training that that test use test
words python that test python this test use words this validation cat cat words words	words test that cat cat validation this test that this
who use cat that this python that python python cat training python validation python cat	that validation cat who validation test use validation this words
use test use python cat validation words who validation test words words cat test training	this python cat words python this validation training training who
that use who cat test use cat who training validation python cat training words test	words test cat python cat test validation that training cat
this cat this who that words words this use python cat this cat test training	validation validation that cat who cat python python python words
use this test cat words cat use cat who cat cat test python words words	that this that cat training validation cat validation python words
cat who python this words use validation cat use that python python validation who validation	words use test that that cat that who training who
words cat words words python words use validation cat training cat words python use words	training cat who that cat test cat that python that
that who validation who training python cat training who test validation test use words words	test cat this training this this who validation use validation
cat validation this cat training validation that cat python cat validation this cat who who	words python words words cat cat validation words python words
who who use who who who cat this cat use this use this use training	that cat cat training cat words cat cat who that
words who use who validation training that words that words who cat training who this	test cat cat this cat training words test who that
this words training who this use validation words cat test this who this cat validation	python words cat training cat use test that cat cat
validation words test python words cat test python cat cat training words words cat training	cat this validation use use this test training test use
words who cat words who validation cat who test cat cat words that validation cat	use words python validation training training who validation training this
python this who use this that this test use validation training use validation cat use	test that that words that validation this validation python cat
use words python test training this test that test words test cat use words that	who cat test validation this training test python validation words
cat test cat cat words training training python who cat this validation who python that	this cat python python validation cat test use cat who
test cat this use validation cat python cat this training who training test that who	cat test use who python that this validation training this
cat validation python this that use training training cat training use training who this use	that test test test use validation validation words cat cat
who cat that words cat validation python use training test cat this words validation cat	words use training words this words that use that python
this validation who who this who training who training cat this that use test validation	who who validation this that who that test cat training
